jp	tw	en	kr
ネコ|ネコビルダー|ネコモヒカン	貓咪|健美貓|摩西根貓	Cat|Macho Cat|Mohawk Cat	고양이|고양이 빌더|고양이 모히칸
タンクネコ|ネコカベ|ゴムネコ	坦克貓|牆貓|橡皮貓	Tank Cat|Wall Cat|Eraser Cat	탱크 고양이|고양이 벽|고무 고양이
バトルネコ|勇者ネコ|暗黒ネコ	戰鬥貓|勇者貓|暗黑貓	Axe Cat|Brave Cat|Dark Cat	배틀 고양이|용사 고양이|암흑 고양이
キモネコ|美脚ネコ|ムキあしネコ	噁心貓|美腿貓|筋肉美腿貓	Gross Cat|Sexy Legs Cat|Macho Leg Cat	징글 고양이|각선미 고양이|불끈다리 고양이
ウシネコ|ネコキリン|ネコライオン	牛貓|長頸鹿貓|獅子貓	Cow Cat|Giraffe Cat|Lion Cat	황소 고양이|기린 고양이|고양이 라이온
ネコノトリ|ネコＵＦＯ|天空のネコ	鳥貓|UFO貓|天空之貓	Bird Cat|UFO Cat|The Flying Cat	고양이 새|고양이UFO|천공의 고양이
ネコフィッシュ|ネコクジラ|ネコ島	魚貓|鯨貓|島貓	Fish Cat|Whale Cat|Island Cat	고양이 피쉬|고양이 고래|고양이 섬
ネコトカゲ|ネコドラゴン|ネコキングドラゴン	蜥蜴貓|龍貓|龍王貓	Lizard Cat|Dragon Cat|King Dragon Cat	고양이 도마뱀|고양이 드래곤|고양이 킹드래곤
巨神ネコ|ネコダラボッチ|ネコジャラミ	巨神貓|巨人貓|賈拉米貓	Titan Cat|Mythical Titan Cat|Jamiera Cat	거신 고양이|고양이 다라보치|고양이 쟈라미
ネコ女優|ネコ聖母|ネコマッチョ	女優貓|聖母貓|猛男貓	Actress Cat|Mother Cat|Beefcake Cat	고양이 여배우|고양이 성모|고양이 마초
カンフーにゃんこ|酔拳にゃんこ|ネコダンサー	功夫貓|醉拳貓|舞者貓	Kung Fu Cat|Drunken Master Cat|Dancer Cat	쿵후 냥코|취권 냥코|고양이 댄서
Mr.|Super Mr.|Hyper Mr.	Mr.|Super Mr.|Hyper Mr.	Mr.|Super Mr.|Hyper Mr.	Mr.|Super Mr.|Hyper Mr.
猫縛り|猫縛りNEO|猫縛り極上	緊縛貓|緊縛貓NEO|極上緊縛貓	Bondage Cat|Bondage CatNEO|Ultimate Bondage Cat	고양이 밧줄|고양이 밧줄NEO|고양이 밧줄 궁극
女王猫|処刑人|暗黒嬢	女王貓|處刑人|暗黑姊	Dom Cat|Executioner|Dark Lazer	여왕 고양이|처형인|다크 라이더
ネコの箱詰め|ネコギャング|重機C・A・T	箱貓|惡少貓|重機C・A・T	Cats in a Box|Cat Gang|Heavy Assault C.A.T.	고양이 한박스|고양이 갱단|중기 C・A・T
ネコパンツ|ネコ葉っぱ|ネコぺろきゃん	三角褲貓|葉子貓|害羞貓	Panties Cat|Leaf Cat|Lollycat	고양이 팬티|고양이 잎사귀|고양이 캔디
もねこ|スターもねこ|スーパースターもねこ	萌貓|偶像萌貓|超級偶像萌貓	Moneko|Miss MONEKO|Superstar MONEKO	귀여미|스타 귀여미|슈퍼 스타 귀여미
ネコリンリン|ネコワイルド|イチリンリン	輪輪貓|越野貓|單輪車貓	Tricycle Cat|Biker Cat|Unicycle Cat	고양이 세발자전거|고양이 와일드|고양이 외발자전거
ネコ忍者|ガマネコ忍者|ムササビネコ忍者	忍者貓|蛤蟆忍者貓|飛天忍者貓	Ninja Cat|Ninja Frog Cat|Flying Ninja Cat	고양이 닌자|개구리 고양이 닌자|날다람 고양이 닌자
ネコゾンビ|デビルネコ|ネコボーン	殭屍貓|惡魔貓|骷髏貓	Zombie Cat|Devil Cat|Skelecat	고양이 좀비|데빌 고양이|고양이 해골
ネコざむらい|ネコナイト|ネコパティシエ	武士貓|騎士貓|西點師傅	Samurai Cat|Knight Cat|Pastry Cat	고양이 무사|고양이 나이트|고양이 파티쉐
スモウネコ|マダム・ザ・スモウ|ネコにぎり	相撲貓|相撲女士|貓飯糰	Sumo Cat|Madame Sumo|Riceball Cat	스모 고양이|마담·더·스모|고양이 주먹밥
ネコフィーバー|ネコカーニバル|ネコアミーゴ	狂歡貓|嘉年華貓|ＡＭＩＧＯ貓	Boogie Cat|Samba Cat|Gato Amigo	고양이 피버|고양이 카니발|고양이 아미고
ネコスカート|ネコタイツ|ねこななふん	短裙貓|絲襪貓|兜襠布貓	Skirt Cat|Tights Cat|Loincloth Cat	고양이 스커트|고양이 타이츠|고양이 훈도시
ネコヴァルキリー|ネコヴァルキリー・真|ネコヴァルキリー・聖	瓦爾基麗貓|真・瓦爾基麗貓|瓦爾基麗貓・聖	Valkyrie Cat|True Valkyrie Cat|Holy Valkyrie Cat	고양이 발키리|고양이 발키리·진|고양이 발키리・성
ネコムート|狂乱のネコムート|覚醒のネコムート	姆特貓|狂亂姆特貓|覺醒姆特貓	Bahamut Cat|Crazed Bahamut Cat|Awakened Bahamut Cat	고양이 무트|광란의 고양이 무트|각성의 고양이 무트
ケリ姫|フルカラーケリ姫|ウェディングケリ姫	飛踢公主|全彩飛踢公主|婚紗飛踢公主	Kerihime|Full color Kerihime|Bridal Princess Punt	발차기 공주|올 컬러 발차기 공주|웨딩 발차기 공주
ネコひめ|ネコひめビューティ	貓公主|美貓公主	Cat Princess|Cat Princess beauty	고양이 공주|고양이 공주 뷰티
ネコカプセル|ねこ盛り	膠囊貓|膠囊兄弟貓	Capsule Cat|Cramped Cats	고양이 캡슐|고양이 듬뿍
マスクオブネコ|ネコレスラー	面具貓|摔角選手貓	Masked Cat|Luchador Cat	마스크 오브 고양이|고양이 레슬러
ネコぼさつ|ネコせんじゅ|ネコにょらい	菩薩貓|千手貓|如來貓	Bodhisattva Cat|Avalokitesvara Cat|Tathagata Cat	고양이 보살|고양이 천수관음|고양이 여래
ネコ番長|怒りのネコ番長|押忍！ネコ番長	貓咪番長|憤怒的貓咪番長|押忍！貓咪番長	Delinquent Cat|Angry Delinquent Cat|Ultra Delinquent Cat	고양이 일진|분노의 고양이 일진|격노의 고양이 일진
ネコザイル|ネコ裸踊り|ネコカンカン	放浪貓弟|裸舞貓|康康舞貓	Hip Hop Cat|Dancing Flasher Cat|Can Can Cat	고양이 댄스|고양이 알몸 댄스|고양이 캉캉
ねこタツ|ねこＴＶ|ねこタコつぼ	暖桌貓|電視貓|章魚壺貓	Kotatsu Cat|Sadako Cat|Octopus Cat	고타츠양이|고양이TV|고양이 문어단지
ネコルガ|ケサランパサラン|ウルトラケサラン	不明貓|不明白骨貓|超人白骨貓	Nekoluga|Unknown Cat|Ultralan Pasalan	고양이 루가|케사란파사란|울트라 케사란
オタネコ|ネコハッカー|ネコスーパーハッカー	御宅貓|駭客貓|高階駭客貓	Nerd Cat|Hacker Cat|Cyberpunk Cat	오덕 고양이|고양이 해커|고양이 슈퍼 해커
ネコスイマー|ネコバタフライ|ネコ半魚人	快泳貓|蝶泳貓|半魚人貓	Swimmer Cat|Butterfly Cat|Fishman Cat	고양이 스위머|고양이 버터플라이|고양이 반인어
ネコホッピング|ネコマサイ|ネコキョンシー	跳跳貓|馬賽貓|跳跳殭屍貓	Pogo Cat|Masai Cat|Jiangshi Cat	고양이 홉핑|고양이 마사이|고양이 강시
ネコ車輪|ネコ太陽|ネコクール	車輪貓|太陽貓|雪花貓	Wheel Cat|Solar Cat|Chill Cat	고양이 차륜|고양이 태양|고양이 쿨
ネコリンゴ|カオルくん|ネコアップル	蘋果貓|臉貓|iCat	Apple Cat|Face Cat|iCat	고양이 사과|왕대갈이군|iCat
ネコバスたぶ|セクシーネコバスたぶ|ネコバスたぶゴールデン	浴缸貓|性感浴缸貓|黃金浴缸貓	Bath Cat|Sexy Bathtub Cat|Luxury Bath Cat	고양이 욕조|섹시 고양이 욕조|고양이 욕조 골드
ネコエステ|ネコジェンヌ|ネコパーフェクト	美容貓|巴黎時尚貓|窈窕佳人貓	Salon Cat|Paris Cat|Cyborg Cat	고양이 에스테|고양이 젠느|고양이 퍼펙트
ネコアイス|ネコアイスクイーン|ネコアイスクリスタル	冰雪貓|冰雪女王貓|冰雪水晶貓	Ice Cat|Ice Queen Cat|Ice Crystal Cat	고양이 아이스|고양이 아이스퀸|고양이 아이스 크리스탈
ネコマシン|ネコマシン・破|ネコマシン・滅	機器貓|機器貓・破|機器貓・滅	Cat Machine|Cat Machine Mk 2|Cat Machine Mk 3	고양이 머신|고양이 머신・파|고양이 머신・멸
鬼にゃんま|鬼神にゃんま|獄炎鬼にゃんま	惡鬼喵魔|鬼神喵魔|獄炎鬼喵魔	Lesser Demon Cat|Greater Demon Cat|Greater Balrog Cat	도깨비 야옹마|도깨비신 야옹마|헬파이어 도깨비 야옹마
芸者ねこ|ネコでありんした	藝妓貓|小百合	Maiko Cat|Geisha Cat	게이샤 고양이|고양이였사옵니다
ねこジュラ|ねこジュラシッター|ねこジュラザウルス	侏羅貓|侏羅貓保姆|侏羅恐龍貓	Jurassic Cat|Jurassic Cat Sitter|Catasaurus	고양이 쥬라|고양이 쥬라싯터|고양이 쥬라 사우루스
ねこファイター|メガトンファイター|マキシマムファイター	鬥士貓|重量級鬥士貓|極限鬥士貓	Viking Cat|Thor Cat|Maximum the Fighter	고양이 파이터|메간톤 파이터|맥시멈 파이터
ねこ海賊|ニャーコック船長|ニャック・スパロウ	海賊貓|虎克貓船長|喵克・史派羅	Pirate Cat|Captain Cat|Dread Pirate Catley	고양이 해적|냐옹 쿡선장|냥・스페로
ねこ泥棒|怪盗ニャコン|ネゴエモン	小偷貓|怪盜貓|五右衛門貓	Thief Cat|Phantom Thief Cat|Goemon Cat	고양이 도둑|괴도 야콘|고양이 에몽
ねこ僧侶|ねこ坊主|ねこ法師	僧侶貓|和尚貓|法師貓	Bishop Cat|Monk Cat|Sanzo Cat	고양이 승려|고양이 스님|고양이 법사
ねこ占い師|ねこふんど師|ねこ医師	占卜貓|漁民貓|醫師貓	Fortune Teller Cat|Fisherman Cat|Doctor Cat	고양이 점쟁이|고양이 어부|고양이 의사
ネコシャーマン|ネコラマンサー|ネコオドラマンサー	薩滿貓|通靈貓|魔舞通靈貓	Shaman Cat|Necromancer Cat|Necro-Dancer Cat	고양이 샤먼|고양이 라만사|고양이 라만사 댄스
エヴァンジェリスト|フィリバスター	福音傳教貓|議事阻撓貓	Evangelist Cat|Filibuster Cat	에반젤리스트|필리버스터
10式戦車|ネコ搭乗10式戦車	|	|	|
ネコ魔女|ネコマージョ|ネコビマージョ	魔女貓|女巫貓|美魔女貓	Witch Cat|Sorceress Cat|Enchantress Cat	고양이 마녀|고양이 위치|고양이 소서리스
ネコアーチャー|ネコキューピット|ネコいて座	弓箭手貓|丘比特貓|射手座貓	Archer Cat|Cupid Cat|Cataur	고양이 아처|고양이 큐피트|고양이 궁수자리
ネコシュバリエ|ネコベルセルク|ネコパラディン	巨劍騎士貓|狂戰士貓|聖騎士貓	Marauder Cat|Berserker Cat|Paladin Cat	고양이 슈발리에|고양이 베르세르크|고양이 파라딘
ネコ魔剣士|双剣ネコ魔剣士|双炎舞ネコ魔剣士	魔劍士貓|雙劍魔劍士貓|雙焰舞魔劍士貓	Swordsman Cat|Sword Master Cat|Elemental Duelist Cat	고양이 마검사|쌍검 고양이 마검사|쌍염무 고양이 마검사
ねこベビー|ねこベビーズ|ネコベビーカーズ|ネコベビーワールド	貓咪Baby|貓咪Babies|貓咪嬰兒車|貓咪嬰兒世界	Baby Cat|Baby Cats|Cats in the Cradle|Cats in the Stroller	고양이 베이비|고양이 베이비즈|고양이 베이비카트|고양이 베이비월드
ネコブ・ロンズ|芸術のネコスタチュ|ネコクイズ王	銅像貓|行動藝術貓|貓咪猜謎王	Bronze Cat|Michelangelo Cat|Quizmaster Cat	고양이브・론즈|예술의 고양이스테츄|퀴즈왕 고양이
ねこ寿司|ねこリーゼント|ネコ極上	壽司貓|炸蝦貓|極品鮭卵貓	Sushi Cat|Fried Shrimp Cat|Roe Cat	고양이 스시|고양이 리젠트|고양이 연어알
ネコポン|ネコポニョン	轉蛋機貓|長型轉蛋機貓	Toy Machine Cat|Vendor Cat	고양이퐁|고양이뽀용
ネコ運動会|ネコラッチ|ネコ棒倒し	運動會貓|綁匪貓|倒棒貓	Sports Day Cat|Kidnapper Cats|Rampage Cats	고양이 운동회|고양이 납치|고양이 봉
剣士|剣士ジョニー	劍客|劍客強尼	Swordsman|Swordsman Johnny	검사|검사 죠니
ウシ姫|キリン姫	牛公主|長頸鹿公主	Cow Princess|Giraffe Princess	황소 공주|기린 공주
KHM48|ダークKHM48|KHM46	KHM48|暗黑KHM48|KHM46	PPT48|Dark PPT48|PPT46	BCK48|다크 BCK48|BCK46
チビガウ|チビガウガウ|クリスタルチビガウガウ	小暴龍|小暴暴龍|水晶小暴暴龍	Li'l Gau|Li'l Gau Gau|Crystal Li'l Gau Gau	꼬마 가우|꼬꼬마 가우|크리스탈 꼬꼬마 가우
執行者|執行者999|ジャッジメント	鐮刀使者|鐮刀使者999|審判使者	Reaper|Reaper 999|Judgment	사신|사신999|저지먼트
眠れるケリの美女|眠れるケリの美女Ⅱ|ひたすら眠れるケリの美女	飛踢睡美人|飛踢睡美人II|熟睡飛踢睡美人	Sleeping Beauty Punt|Sleeping Beauty Punt II|Oversleeping Beauty Punt	잠자는 발차기 공주|잠자는 발차기 공주Ⅱ|꿀잠자는 발차기 공주
ネコリーマン|ネコ怨み|ネコ火祭り	上班族貓|怨恨貓|火舞貓	Salaryman Cat|Grudge Cat|Ritual Cat	고양리맨|고양이 원혼|고양이 분노
真田幸村|武神・真田幸村|飛翔の武神・真田幸村	真田幸村|武神・真田幸村|飛翔武神・真田幸村	Sanada Yukimura|Wargod Yukimura|Immortal Yukimura	그리폰|분노의 그리폰|비약의 무신・그리폰
前田慶次|武神・前田慶次|憤怒の武神・前田慶次	前田慶次|武神・前田慶次|憤怒武神・前田慶次	Maeda Keiji|Wargod Keiji|Immortal Keiji	백호|분노의 백호|진노의 백호
織田信長|武神・織田信長|天魔・織田信長|夢幻天魔・織田信長	織田信長|武神・織田信長|天魔・織田信長|夢幻天魔・織田信長	Oda Nobunaga|Wargod Nobunaga|Immortal Nobunaga|Phantasmal Nobunaga	하데스|분노의 하데스|천마의 하데스|몽환천마 하데스
トナカイフィッシュ|ネコ魚のお造り|フィッシュ・ド・ノエル	馴鹿魚|魚貓的刺身|聖誕樹幹蛋糕貓	Reindeer Fish Cat|Sashimi Cat|Xmas Pudding Cat	순록피쉬|고양이회 모듬|피쉬・더・노엘
風神のウィンディ|風神のウィンディα|疾風神のウィンディα|アルティメットウィンディα	風神溫蒂|風神溫蒂α|疾風神溫蒂α|究極溫蒂α	Windy|Windy, type α|Divine Windy|Ultimate Windy	바람의 신・윈디|바람의 신・윈디α|질풍의 신・윈디α|얼티밋・윈디α
雷神のサンディア|雷神のサンディアβ|迅雷神のサンディアβ	雷神珊迪亞|雷神珊迪亞β|迅雷神珊迪亞β	Thundia|Thundia, type β|Divine Thundia	번개의 신・산디아|번개의 신・산디아β|천둥의 신・산디아β
ドロイド|ニャンドロイド|ハルドロイド	Droid|Droid喵|Droid春	Droid Cat|Droid Cat Mk 2|SpringDroid	드로이드|야옹로이드|스프링 드로이드
ネコと宇宙|ニャア少佐|駆動戦士ネコ	貓和宇宙|喵亞少校|驅動戰士貓咪	Space Cat|Major Space Cat|Space Marine Cat	고양이와 우주|냐앙소령|우주전사 고양이
にゃんこ成人|にゃんこ病人|にゃんこ囚人	成人貓|病人貓|囚犯貓	Adult Cat|Sick Cat|Prisoner Cat	냥코 성인|냥코 환자|냥코 죄수
吾輩は鬼である|ネコ紳士|ネコ紳士同盟	我是鬼|紳士貓|紳士貓同盟	Evil Cat|Gentleman Cat|Gentleman Bros.	내가 도깨비라오|고양이 신사|고양이 신사 동맹
ひなにゃんこ|超号珍ニャジンガー|ニャラジン	人偶貓咪|超合金貓|神燈貓	Doll Cats|Cat-o-tron|Nyalladin	냥코 부부|야징가 로보|냥라진
ネコ忍者～青～|ネコ忍者～橙～	忍者貓～藍～|忍者貓～橘～	Blue Shinobi|Orange Shinobi	고양이 닌자~청~|고양이 닌자~주황~
地龍ソドム|地龍王ソドム|地龍皇帝ソドム	地龍索多姆|地龍王索多姆|地龍皇帝索多姆	Sodom|Earth King Sodom|God-Emperor Sodom	지룡 소돔|지룡왕 소돔|지룡황제 소돔
聖龍メギドラ|聖龍王メギドラ|聖龍皇帝メギドラ	聖龍梅基多拉|聖龍王梅基多拉|聖龍皇帝梅基多拉	Megidora|Holy Dragon Megidora|God-Emperor Megidora	성룡 메기도라|성룡왕 메기도라|성룡황제 메기도라
竜騎士バルス|竜騎士王バルス|竜騎士皇帝バルス	龍騎士巴魯斯|龍騎士王巴魯斯|龍騎士皇帝巴魯斯	Vars|Dragon King Vars|God-Emperor Vars	용기사 바르스|용기사왕 바르스|용기사황제 바르스
神龍かむくら|神龍王かむくら|神龍皇帝かむくら	神龍卡姆庫拉|神龍王卡姆庫拉|神龍皇帝卡姆庫拉	Kamukura|God Dragon Kamukura|God-Emperor Kamukura	신룡 카무쿠라|신룡왕 카무쿠라|신룡황제 카무쿠라
竜戦機ライデン|竜戦機王ライデン|竜戦機皇帝ライデン	龍戰機雷電|龍戰機王雷電|龍戰機皇帝雷電	Raiden|Dragonslayer Raiden|God-Emperor Raiden	용병기 라이덴|용병기왕 라이덴|용병기황제 라이덴
ネコなわとび|ネコネコなわとび|ネコ蕎麦屋	跳繩貓|雙人跳繩貓|雙人桿麵貓	Rope Jump Cat|Pair Rope Jump Cat|Noodle Cats	고양이 줄넘기|고양고양 줄넘기|고양이 국수
ニムエ|帰化型ニムエ	|	|	니무에|귀화형 니무에
猿王|SSS猿王	|	|	|
狂乱のネコ|狂乱のネコビルダー|大狂乱のネコモヒカン	狂亂貓|狂亂健美貓|大狂亂摩西根貓	Crazed Cat|Crazed Macho Cat|Manic Mohawk Cat	광란의 고양이|광란의 고양이 빌더|대광란의 고양이 모히칸
狂乱のタンクネコ|狂乱のネコカベ|大狂乱のゴムネコ	狂亂坦克貓|狂亂牆貓|大狂亂橡皮貓	Crazed Tank Cat|Crazed Wall Cat|Manic Eraser Cat	광란의 탱크 고양이|광란의 고양이 벽|대광란의 고무 고양이
狂乱のバトルネコ|狂乱の勇者ネコ|大狂乱の暗黒ネコ	狂亂戰鬥貓|狂亂勇者貓|大狂亂暗黑貓	Crazed Axe Cat|Crazed Brave Cat|Manic Dark Cat	광란의 배틀 고양이|광란의 용사 고양이|대광란의 암흑 고양이
狂乱のキモネコ|狂乱の美脚ネコ|大狂乱のムキあしネコ	狂亂噁心貓|狂亂美腿貓|大狂亂筋肉美腿貓	Crazed Gross Cat|Crazed Sexy Legs Cat|Manic Macho Legs	광란의 징글 고양이|광란의 각선미 고양이|대광란의 불끈다리 고양이
狂乱のウシネコ|狂乱のキリンネコ|大狂乱のネコライオン	狂亂牛貓|狂亂長頸鹿貓|大狂亂獅子貓	Crazed Cow Cat|Crazed Giraffe Cat|Manic Lion Cat	광란의 황소 고양이|광란의 기린 고양이|대광란의 고양이 라이온
狂乱のネコノトリ|狂乱のネコUFO|大狂乱の天空のネコ	狂亂鳥貓|狂亂UFO貓|大狂亂天空之貓	Crazed Bird Cat|Crazed UFO Cat|Manic Flying Cat	광란의 고양이 새|광란의 고양이 UFO|대광란의 천공의 고양이
狂乱のネコフィッシュ|狂乱のネコクジラ|大狂乱のネコ島	狂亂魚貓|狂亂鯨貓|大狂亂島貓	Crazed Fish Cat|Crazed Whale Cat|Manic Island Cat	광란의 고양이 피쉬|광란의 고양이 고래|대광란의 고양이 섬
狂乱のネコトカゲ|狂乱のネコドラゴン|大狂乱のネコキングドラゴン	狂亂蜥蜴貓|狂亂龍貓|大狂亂龍王貓	Crazed Lizard Cat|Crazed Dragon Cat|Manic King Dragon	광란의 고양이 도마뱀|광란의 고양이 드래곤|대광란의 고양이 킹드래곤
狂乱の巨神ネコ|狂乱のネコダラボッチ|大狂乱のネコジャラミ	狂亂巨神貓|狂亂巨人貓|大狂亂賈拉米貓	Crazed Titan Cat|Crazed M. Titan Cat|Manic Jamiera Cat	광란의 거신 고양이|광란의 고양이 다라보치|대광란의 고양이 쟈라미
ネコ乙女|モトコ|サホリ	少女貓|運動女貓|摔角女貓	Maiden Cat|Sportsgirl Cat|Wrestling Cat	고양이 소녀|모솔 고양이|장미냥
弱酸性エル|弱酸性エルCC	|	|	약산성 엘|약산성 엘CC
レッドマローン|レッドマローンCC	|	|	레드 마론|래드 마론CC
歌謡にゃんこ|メガにゃんこ|メガにゃんこEX	歌謠貓|歌后貓|歌后貓EX	Cabaret Cat|Mega Cat|Mega Cat EX	가왕 냥코|메가 냥코|메가 냥코 EX
マジでコイしてる|コイ・the・Night|キスヨリ・ス・ゴイ	至死不渝的戀情|戀愛・the・Night|超越熱吻之戀	Koi Cat|Gross Koi Cat|Kiss and Koi	물 만난 물고기|물 만난 고양이|바람 만난 고양이
猿帝のクウ|猿帝のクウγ|金猿帝のクウγ	猿帝・悟空貓|猿帝・悟空貓γ|金猿帝・悟空貓γ	Kuu|Kuu, type γ|Divine Kuu	쿠우|쿠우γ|골드 쿠우γ
召し豚のカイ|召し豚のカイμ|召し猪のカイμ	召喚・八戒貓|召喚・八戒貓μ|大召喚・八戒貓μ	Kai|Kai, type μ|Divine Kai	카이|카이μ|슈퍼 카이μ
宝杖のカッパーマイン|宝杖のカッパーκ|光宝杖のカッパーκ	寶杖使者・悟淨貓|寶杖使者・悟淨貓κ|光寶杖使者・悟淨貓κ	Coppermine|Coppermine, type κ|Divine Coppermine	갓파 마인|갓파κ|샤이니 갓파κ
にゃんこ３兄弟|秘密要塞ネコロス	貓咪三兄弟|秘密要塞貓克羅斯	Cat Bros|Secret Base	냥코 3형제|비밀요새 마기로스
マダム・ザ・花嫁|マダム・ザ・王様|マダム・ザ・サバンナ	新娘太太|國王太太|大草原太太	Madam Bride|Madam King|Madam the Savannah	마담・더・신부|마담・더・킹|마담・더・사반나
セレス|セレスCC	賽蕾絲|賽蕾絲CC	Celesse|Celesse CC	세레스|세레스CC
ノノ|ノノCC|野跳ねる白猫ノノCC	諾諾|諾諾CC|躍動的白貓諾諾CC	Nono|Nono CC|Frolicking Nono CC	노노|노노CC|하얀 고양이 노노CC
オルガ|オルガCC	奧爾加|奧爾加CC	Olga|Olga CC	올가|올가CC
ノルン|ノルンCC	諾倫|諾倫CC	Norn|Norn CC	노룬|노룬CC
よいち|よいちCC	優依|優依CC	Yoichi|Yoichi CC	요이치|요이치CC
セラム|セラムCC	賽拉姆|賽拉姆CC	Serum|Serum CC	세럼|세럼CC
フウ|フウCC	弗舞|弗舞CC	Fuu|Fuu CC	후우|후우CC
アウラ|アウラCC	阿烏拉|阿烏拉CC	Aura|Aura CC	아우라|아우라CC
レイ|レイCC	雷伊|雷伊CC	Rei|Rei CC	레이|레이CC
ワイバーン|ニャイバーン|ニャイバーン＆アレク	飛翼龍|喵翼龍|喵翼龍＆阿雷克	Wyvern|Wyvern Cat|Wyvern and Alec	와이번|냥이번|냥이번&알렉
癒術士|癒術士CC|にゃんこ化癒術士ＣＣ	癒術士|癒術士CC|喵化癒術士CC	Healer|Healer CC|Healer Cat CC	유술사|유술사CC|냥코화 유술사CC
メルク|メルクCC|にゃんことメルクCC	梅露可|梅露可CC|貓咪與梅露可CC	Merc|Merc CC|Merc & Cat CC	메르크|메르크CC|냥코와 메르크CC
女王様の休日|いつものＯＬ|コールセンターのＯＬ	女王的假期|普通的ＯＬ|總機的ＯＬ	Vacation Queen|Office Lady Cat|Call Center Cat	여왕님의 휴일|평범한 오피스 레이디|콜센터 레이디
マメマメにゃんこ|ラブラブにゃんこ|ヴァルヴァルにゃんこ	豌豆貓|內在美貓|瓦爾裝甲貓	Bean Cats|Brah Cats|Val Val Cat	콩콩 냥코|럽럽 냥코|발키리 냥코
伊達政宗|武神・伊達政宗|邪眼竜の武神・伊達政宗	伊達政宗|武神・伊達政宗|邪眼龍武神・伊達政宗	Date Masamune|Wargod Masamune|Immortal Masamune	오딘|분노의 오딘|사안의 오딘
武田信玄|武神・武田信玄|猛牛の武神・武田信玄	武田信玄|武神・武田信玄|猛牛武神・武田信玄	Takeda Shingen|Wargod Shingen|Immortal Shingen	아수라|분노의 아수라|분노의 투우 아수라
カラクリにゃんこ|ネコ人形師|ネコチャッピー	機關人偶貓|人型師貓|人型師與鬼娃貓	Clockwork Cat|Puppetmaster Cat|Puppetmaster & Charley	꼭두각시 냥코|고양이 인형사|고양이 채피
ネコフラワー|にゃんこ扇風|ネコボンバー	花盆貓|風扇貓|炸彈貓	Flower Cat|Cooldown Cat|Bombercat	고양이 플라워|냥코 선풍기|고양이 봄버
うらめしにゃん|ハナメガにゃん|凧にゃん	幽魂吶吶|大鼻子眼鏡|風箏貓	Vengeful Cat|Groucho Cat|Kite Cat	처녀귀신 냥코|냥코안경|연날리기 냥코
金ネコ|金ネコビルダー|金ピカネコビルダー	黃金貓|黃金健美貓|黃金耀眼健美貓	Gold Cat|Gold Macho Cat|Glittering Macho Cat	골드 고양이|골드 고양이 빌더|순금 고양이 빌더
ウルフとウルルン|タマとウルルン|覚醒のタマとウルルン	狼與少女|小咪與少女|覺醒的小咪與少女	Ururun Wolf|Ururun Cat|Awakened Ururun	울프와 우루룬|나비와 우루룬|각성의 나비와 우루룬
ねねこ|スターねねこ	萌萌貓|偶像萌萌貓	Neneko|Miss NENEKO	귀요미|스타 귀요미
カンフーにゃんこＧ|酔拳にゃんこＧ|剛拳にゃんこＧ	功夫貓Ｇ|醉拳貓Ｇ|剛拳貓Ｇ	Kung Fu Cat X|Drunken Master Cat X|Iron Claw X	쿵후 냥코G|취권 냥코G|강권 냥코G
ヒカキン|ビキャキン|ムキャキン	||	||	||
うらしまタロウ|竜宮獣ガメレオン|竜宮超獣キングガメレオン	浦島太郎|龍宮獸・變色龍|龍宮超獸・變色龍王	Urashima Taro|Guardian Gamereon|King Gamereon	냥꼬북|용궁수 거북레온|용궁초수 킹거북레온
ツルの恩返し|銀河戦士コスモ|究極戦士コズミックコスモ|究極勇者ウルトラコスモ	白鶴貓|銀河戰士・小宇宙|究極戰士・黃金小宇宙|究極勇者・超級小宇宙	The Grateful Crane|Super Galaxy Cosmo|Ultima Galaxy Cosmo|Supernova Cosmo	크레인 냥코|은하전사 코스모|궁극전사 코즈믹 코스모|궁극용사 울트라 코스모
ももたろう|爆走兄弟ピーチスター|爆走兄弟ピーチジャスティス	桃太郎|爆走兄弟・桃星|爆走兄弟・桃色正義	Momotaro|The Peach Angels|The Peach Devils	복숭아 동자|폭주형제 피치스타즈|폭주형제 피치저스티스
かさじぞう|地蔵要塞カムイ|地蔵要塞ゼロカムイ	斗笠地藏|地藏要塞・神威|地藏要塞・金甲神威	Kasa Jizo|Jizo's Moving Castle|Jizo's Mega-Castle	석공 냥돌이|이동요새 카무이|이동요새 골드카무이
かぐやひめ|破壊衛星デスムーン|破壊衛星カオスムーン|ウルトラかぐやひめ	輝夜姬|破壞衛星・死之月|破壞衛星・混沌之月|超級輝夜姬	Princess Kaguya|The Death Moon|The Chaos Moon|Ultra Kaguya	대나무 공주|파괴위성 데스문|파괴위성 카오스문|울트라 대나무 공주
ネコンドー|ネコンドーＨＧ|ネコンドーＳＰ	跆拳貓|跆拳貓ＨＧ|	||	태권도 냥코|태권도 냥코 HG|태권도 냥코 SP
ふにゅふにゅネコ|むきゅむきゅネコ	滾滾貓|壯壯貓	Squish Ball Cat|Muscleman Cat	말랑말랑 고양이|불끈말랑 고양이
神様|シークレット神様	天神|謎之神	God|Secret God	신|시크릿 신
ネコチュートリアル|裏チュートリアル	|	|	|
ねこナース|ハートフルねこナース|ジョイフルねこナース	貓護士|愛心貓護士|粉紅喜悅貓護士	Nurse Cat|Heartful Nurse Cat|Joyful Nurse Cat	고양이 간호사|고양이 나이팅게일|조이풀 고양이 간호사
にゃんこ城Mini|にゃんこ城Jr|にゃんこ城Max	貓咪城Mｉｎｉ|貓咪城Ｊｒ|貓咪城Max	Cat Base Mini|Cat Base Jr.|Cat Base Ultra	냥코 성 mini|냥코 성 Jr|냥코 성 Max
ねこガンマン|ねこウエスタン|ねこロデオ	神槍手貓|木馬牛仔哥|騎牛機神槍手貓	Cat Gunslinger|Cat Eastwood|Rodeo Cat	건맨 고양이|웨스턴 고양이|로데오 고양이
たけうまねこ|トーテムねこ|ねこ雑技団	高蹺貓|圖騰柱貓|貓咪特技團	Stilts Cat|Totem Cat|Acrobat Cats	죽마 고양이|토템 고양이|고양이 잡기단
ブリキネコ|プレーンネコ|ネコロボット	發條貓|飛機貓|機械人貓	Tin Cat|Plane Cat|Robocat	양철 고양이|양철 비행기 고양이|로봇 고양이
ねこロッカー|ねこアーティスト|ねこラーメン道	搖滾貓|藝術家貓|拉麵王貓	Rocker Cat|Artist Cat|Ramen Cat	고양이 로커|고양이 아티스트|고양이 라면의 길
ねこ人魚|ねこソルジャー|ネコカメラマン	人魚貓|女兵貓|攝影師貓	Mer-Cat|Commando Cat|Cameraman Cat	인어 고양이|솔져 고양이|카메라맨 고양이
窓辺の乙女ネコ|窓辺の姫君ネコ|窓辺の舞妓にゃん	窗邊少女貓|窗邊躁女貓|窗邊舞妓貓	Juliet Cat|Princess Juliet Cat|Juliet the Maiko	창가의 소녀 고양이|창가의 공주 고양이|창가의 무희 고양이
ネコバーベル|ネコRG|ネコデリバリー	舉重貓|舉牌女郎貓|外送貓	Weightlifter Cat|Ring Girl Cat|Pizza Cat	고양이 바벨|고양이RG|고양이 딜리버리
ネコスケート|よいではにゃいか|にゃんでやねん	冰刀二人組|調戲二人組|旺福二人組	Figure Skating Cats|Drama Cats|Slapstick Cats	고양이 스케이트|고양이 요요|고양이 콤비
ネコトースター|ネコ映写機|ネコクラシック	麵包機貓|貓咪投影機|貓咪留聲機	Cat Toaster|Cat Projector|Catophone	고양이 토스터|고양이 영사기|고양이 클래식
ねこフープ|ねこトリプルフープ|ねこグルグルフープ	呼拉圈貓|三層呼拉圈貓|五層呼拉圈貓	Hoop Cat|Showoff Cat|Hoopmaster Cat	고양이 훌라|고양이 트리플 훌라|고양이 스프링 훌라
156-1|156-2	|	|	|
ドラリー剣士|ドラリー魔法使い	|	|	|
ヌボボ|ゴールボ	|	|	|
上杉謙信|武神・上杉謙信|暴威の武神・上杉謙信|毘沙門軍神・上杉謙信	上杉謙信|武神・上杉謙信|亂爆武神・上杉謙信|多聞天軍神・上杉謙信	Uesugi Kenshin|Wargod Kenshin|Immortal Kenshin|Hellrider Kenshin	사라만다|분노의 사라만다|격노의 사라만다|격노군신 사라만다
冥界のカリファ|冥界のＸカリファ|冥界のＸＸカリファ	冥界卡莉法|冥界卡莉法Ｘ|冥界卡莉法ＸＸ	Kalisa|Kalisa, type χ|Divine Kalisa	명계의 칼리파|명계의X칼리파|명계의XX칼리파
ユーリンチー|転生霊鳥ユーリンチー|ゲキリンチー	幽靈鷙|轉生靈鳥幽靈鷙|怒靈鷙	Yurinchi|Phoenix Yurinchi|Gekirinchi	피닉스|영생불사 피닉스|다크피닉스
狂乱のケリ姫|狂乱のケリ姫CC|大狂乱のケリ姫	狂亂飛踢公主|狂亂飛踢公主CC|大狂亂飛踢公主	Crazed Princess Punt|Crazed Princess Punt CC|Manic Princess Punt	광란의 발차기 공주|광란의 발차기 공주CC|대광란의 발차기 공주
綾小路 翔|翔やん＆にゃんこ	|	|	|
早乙女 光|光＆にゃんこ	|	|	|
西園寺 瞳|トミー＆にゃんこ	|	|	|
星グランマニエ|ランマ＆にゃんこ	|	|	|
白鳥松竹梅|松＆にゃんこ	|	|	|
ネコヤンキー|ネコスケバン	|	|	|
アシルガ|アシランパサラン|アタタタアシラン	踢腳貓|長腳白骨貓|我打打打長腳白骨貓	Asiluga|Asilan Pasalan|Assassinlan Pasalan	아시루가|아시란파사란|아타타타아시란
クビルガ|クビランパサラン|E・クビランパサラン	頭槌貓|長頸白骨貓|E・長頸白骨貓	Kubiluga|Kubilan Pasalan|E. Kubilan Pasalan	쿠비루가|쿠비란파사란|E・쿠비란파사란
テコルガ|テサランパサラン|ムギワラテサラン	手甩貓|長手白骨貓|草帽長手白骨貓	Tecoluga|Tesalan Pasalan|Lufalan Pasalan	테코루가|테사란파사란|밀짚모자 테사란
バララガ|バラランパサラン|ピカランバララン	異能貓|異能白骨貓|閃光異能白骨貓	Balaluga|Balalan Pasalan|Piccolan Pasalan	바라라가|바라란파사란|피카란바라란
コニャンダム|ネコニャンダム|覚醒のネコニャンダム	小戰士貓彈|喵彈人|覺醒的小戰士貓彈	Li'l Nyandam|Dark Emperor Catdam|Schoolbus Nyandam	꼬맹이 야옹마|꼬양이 야옹마|각성의 꼬양이 야옹마
厨房マンボウ|工房マンボウ|社会の一員	廚房曼波魚|工房曼波魚|社會的一員	Baby Mola|Young Man Mola|Citizen Mola	어린이 개복치|젊은이 개복치|사회의 일원
マンボ王|生ける伝説|太平洋の主	曼波魚王|生存傳說|太平洋之主	Mola King|Living Legend|Master of the Pacific	개복치 왕|살아있는 전설|태평양의 주인
にゃんぼう|ネコトーピード	喵波|猛波	Meowla Meowla|Catorpedo	냥복치|고양이 톨피드
マシュマロにゃん|キモマロにゃん	棉花糖貓|長腳棉花糖貓	Marshmallow Cat|Creepmallow	마시멜로 냥코|징글마시멜로 냥코
覇龍ディオラムス|覇龍王ディオラムス|覇龍皇帝ディオラムス|大覇龍皇帝ディオラムス	霸龍迪歐拉姆斯|霸龍王迪歐拉姆斯|霸龍皇帝迪歐拉姆斯|大霸龍皇帝迪歐拉姆斯	Dioramos|Archdragon Dioramos|God-Emperor Dioramos|Ascendant Dioramos	패룡 디오라무스|패룡왕 디오라무스|패룡황제 디오라무스|패룡대제 디오라무스
極道にゃんこ|ヤクザヴァンパイア	|	|	|
タクヤとユキ|タクヤとユキとネコ|タクヤとビューティユキ	拓也與小雪|拓也與小雪與貓咪|拓也與美腿小雪	Takuya ＆ Yuki|Takuya, Yuki ＆ Cat|Takuya＆ Lovely Yuki	타쿠야와 유키|타쿠야와 유키와 고양이|타쿠야와 뷰티 유키
謎の少女ユキ|謎の少女ユキ＆ネコ|謎のネコ耳少女ユキ	神秘少女小雪|神秘少女小雪＆貓咪|神秘貓耳少女小雪	Mystery Girl Yuki|Mystery Yuki ＆ Cat|Mystery Catgirl Yuki	수수께끼의 소녀 유키|수수께끼의 소녀 유키&고양이|수수께끼의 고양이귀 소녀 유키
ゆきにゃん|ビューティゆきにゃん	小雪貓|美腿小雪貓	Yuki Cat|Lovely Yuki Cat	고양이 유키|뷰티 고양이 유키
183-1|183-2	|	|	쿠쿠크루12|쿠쿠크루12+1
にゃんこカートR|にゃんこカートG|にゃんこカートP	貓咪賽車R|貓咪賽車G|貓咪賽車G	Cat Kart R|Cat Kart G|Cat Kart P	냥코 카트R|냥코 카트G|냥코 카트P
ミスターニンジャ|タンタン	Mr. Ninja|糖糖	Mr. Ninja|Mint	미스터 닌자|탄탄
ハルシュト|ハルシュトCC|革命のハルシュトCC	哈爾修特|哈爾修特CC|革命的哈爾修特CC	Hearscht|Hearscht CC|Revolutionary Hearscht CC	하루슈토|하루슈토CC|혁명의 하루슈토CC
コーネリア|コーネリアCC	可納莉亞|可納莉亞CC	Cornelia|Cornelia CC	코넬리아|코넬리아CC
ユーヴェンス|ユーヴェンスCC|休日の騎士様ユーヴェンスCC	悠凡斯|悠凡斯CC|假日的騎士悠凡斯CC	Juvens|Juvens CC|Holiday Juvens CC	유벤스|유벤스CC|휴일의 기사님 유벤스CC
ミスティカ|ミスティカCC|寂救のミスティカCC	米絲蒂卡|米絲蒂卡CC|寂救的米絲蒂卡CC	Mystica|Mystica CC|Savior Mystica CC	미스티카|미스티카CC|영안의 미스티카CC
アロイス|アロイスCC	阿洛伊斯|阿洛伊斯CC	Alois|Alois CC	알로이스|알로이스CC
シトルイユ|シトルイユCC	斯托魯伊悠|斯托魯伊悠CC	Citrouille|Citrouille CC	시톨이유|시톨이유CC
ティティ|ティティCC|ネコティティCC	推推|推推CC|貓咪推推CC	Titi|Titi CC|Titi Cat CC	티티|티티CC|고양이 티티CC
山岡実乃里|クイーンみのりん	|	|	|
中村奏絵|クイーンかにー	|	|	|
アキラ|シャドウ・アキラ|インフェルノ・アキラ	阿激拉|幻影・阿激拉|獄炎・阿激拉	Akira|Shadow Akira|Inferno Akira	아키라|쉐도우・아키라|인펠・아키라
西園寺メカ子|ドクトルDr.メカ子|アストロDr.メカ子	西園寺機器子|怪博士Dr.機器子|航太博士Dr.機器子	Mekako Saionji|Dr. Mekako|Mission Control Mekako	메카소녀 진|닥터 메카소녀 진|스페이스 메카소녀 진
キャットマンダディ|キャットマンダーク|キャットマンライジング	貓俠大帝|黑暗貓俠|雷霆貓俠	Catman|Dark Catman|Ultimate Catman	캣맨대디|캣맨다크|캣맨라이징
サイキックネコ|ネオサイキックネコ|デビルサイキックネコ	超能力貓|新世紀超能力貓|超能力貓魔俠	Psychocat|Neo Psychocat|Corrupted Psychocat	사이킥 냥코|네오 사이킥 냥코|데빌 사이킥 냥코
ねこ陰陽師|魔法少女ねこ|ねこ大魔王	貓咪陰陽師|魔法少女貓|貓咪大魔王	Onmyoji Cat|Magica Cat|Thaumaturge Cat	고양이 음양사|마법소녀 고양이|대마왕 고양이
ネコサーファー|ネコ漂流|ネコ漂流記	衝浪貓|漂流貓|貓咪漂流記	Surfer Cat|Castaway Cat|Seafarer Cat	고양이 서퍼|표류 고양이|고양이 표류기
メタルネコ|メタルネコビルダー	鋼鐵貓|鋼鐵健美貓	Metal Cat|Metal Macho	메탈 고양이|메탈 고양이 빌더
ドラムメニャー|プラカードにゃん|ネコぺったん	儀隊指揮貓|舉牌貓|搗麻糬貓	Drumcorps Cat|Banner Cat|Mochi Cat	군악대장|플랜카드 냥코|떡방아 냥코
ネコ小籠包|ネコ大籠包	小籠包貓咪|大籠包貓咪	Baozi Cat|Big Baozi	소룡포 냥코|대룡포 냥코
カチカチヤマンズ|炎護射撃車ウーウー|豪炎狙撃車ウーウー	咔嚓咔嚓山崽子|炎護射擊車ㄛ一ㄛ一|豪炎狙擊車ㄛ一ㄛ一	Kachi-Kachi|Fire Squad Kachiyama|Kachiyama Assault Brigade	너굴냥즈|화염돌격대 너굴냥즈|화염저격대 너굴냥즈
アイルー|アイルー＆メラルー	|	|	|
シェリア【キリン】|シェリア【キリンX】	|	|	|
リオレウス|リオレウス＆にゃんこ	|	|	|
リオレイア|リオレイア＆にゃんこ	|	|	|
キリンネコ|キリンネコキリン	|	|	|
ちびネコ|ちびネコビルダー|ちびネコモヒカン	小小貓|小小健美貓|小小摩西根貓	Li'l Cat|Li'l Macho Cat|Li'l Mohawk Cat	꼬맹이 고양이|꼬맹이 고양이 빌더|꼬맹이 고양이 모히칸
ちびタンクネコ|ちびネコカベ|ちびゴムネコ	小小坦克貓|小小牆貓|小小橡皮貓	Li'l Tank Cat|Li'l Wall Cat|Li'l Eraser Cat	꼬맹이 탱크 고양이|꼬맹이 고양이 벽|꼬맹이 고무 고양이 
ちびバトルネコ|ちび勇者ネコ|ちび暗黒ネコ	小小戰鬥貓|小小勇者貓|小小暗黑貓	Li'l Axe Cat|Li'l Brave Cat|Li'l Dark Cat	꼬맹이 배틀 고양이|꼬맹이 용사 고양이|꼬맹이 암흑 고양이
ホワイトラビット|ブラックキャット|グレーフォックス|スペクトルキャット	白兔女俠|黑貓女俠|灰狐女俠|鎧貓女俠	The White Rabbit|The Black Cat|The Grey Fox|The Spectral Cat	화이트 래빗|블랙 캣|그레이 폭스|스펙트르 캣
にゃんこバーガー|にゃんこキングバーガー|にゃんこバーガーセット	||	Catburger|Cat Royale|Value Meal Cat	||
百太郎|百太郎CC	百太郎|百太郎CC	HYAKUTARO|HYAKUTARO CC	햐쿠타로|햐쿠타로CC
マルコ|マルコCC	馬可|馬可CC	MARCO|MARCO CC	마르코|마르코CC
ターマ|ターマCC	塔瑪|塔瑪CC	TARMA|TARMA CC	타마|타마CC
エリ|エリCC	英里|英里CC	ERI|ERI CC	에리|에리CC
フィオ|フィオCC	菲歐|菲歐CC	FIO|FIO CC	피오|피오CC
SV-001|SV-001CC	SV-001|SV-001CC	SV-001|SV-001 CC	SV-001|SV-001CC
アレン・オニール|アレン・オニールCC	艾倫‧歐尼爾|艾倫‧歐尼爾CC	ALLEN O'NEIL|ALLEN O'NEIL CC	알렌 오닐|알렌 오닐CC
マーズピープル|マーズピープルCC	火星人|火星人CC	MARS PEOPLE|MARS PEOPLE CC	마즈 피플|마즈 피플CC
ヒュージハーミット|ヒュージハーミットCC|ゴールデンヒュージハーミットCC	超巨型戰車|超巨型戰車CC|黃金超巨型戰車CC	HUGE HERMIT|HUGE HERMIT CC|GOLDEN HUGE HERMIT CC	휴즈 허미트|휴즈 허미트CC|골든 허미트CC
ジュピターキング|ジュピターキングCC|ゴールデンジュピターCC	木星王者|木星王者CC|黃金木星王者CC	JUPITER KING|JUPITER KING CC|GOLDEN JUPITER CC	주피터 킹|주피터 킹CC|골든 주피터CC
モーデン元帥|モーデン元帥CC|ゴールデンモーデンCC	惡魔化身・莫丁|惡魔化身・莫丁CC|黃金惡魔化身・莫丁CC	DONALD MORDEN|GENERAL MORDEN|GOLDEN MORDEN CC	모덴 원수|모덴 원수CC|골든 모덴CC
ハイ・ドゥ|ハイ・ドゥCC|ハイ・ドゥ MK III CC	海德|海德CC|海德MK III CC	HI-DO|HI-DO CC|HI-DO MK III	하이 도|하이 도CC|하이 도 MK III CC
呪術師デスピエロ|闇商人バビル|奇術科学者クレイG	咒術師死亡小丑|暗黑商人巴比倫|奇術科學者狂G	Warlock and Pierre|Dark Merchant Babil|Mad Doctor Klay	주술사 데스삐에로|암흑 상인 바빌|과학자 클레이G
にゃんぷきん|ねこランタン|死神ネコ	南瓜貓|燈籠貓|死神貓	Pumpcat|Cat O'Lantern|Harbinger Cat	냥프킨|렌턴 냥프킨|사신 냥프킨
ハロウィンねねこ|ハロウィン魔女ねねこ|仮装・ハロウィンねねこ	萬聖萌萌貓|萬聖魔女萌萌貓|萬聖變裝萌萌貓	Gloomy Neneko|Witchy Neneko|Costumed Witchy Neneko	할로윈 귀요미|할로윈 마녀 귀요미|코스프레 할로윈 귀요미
ウィンディスイート|ウィンディスイートα	甜心溫蒂|甜心溫蒂α	Hallowindy|Hallowindy, type α	윈디 스위트|윈디 스위트α
デビルサンディア|デビルサンディアβ	惡魔珊迪亞|惡魔珊迪亞β	Spooky Thundia|Spooky Thundia, type β	데빌 산디아|데빌 산디아β
おでん|おでんCC	|	|	오뎅|오뎅CC
光の神徒ヴァルキリー|光の神徒ヴァルキリーCC	|	|	빛의 신도 발키리|빛의 신도 발키리CC
神徒ブリュンヒルデ|神徒ブリュンヒルデCC	|	|	신도 브륀힐트|신도 브륀힐트CC
神徒スルズ|神徒スルズCC	|	|	신도 스루즈|신도 스루즈CC
豊穣の女神フレイヤ|豊穣の女神フレイヤCC	|	|	풍요의 여신 프레이야|풍요의 여신 프레이야CC
軍神オーディン|軍神オーディンCC	|	|	군신 오딘|군신 오딘CC
おかめはちもくネコ|おかめの水博士|おかめ名誉客員教授	洞悉先機貓|貓茶水博士|貓茶水名譽客座教授	Freshman Cat Jobs|Prof. Cat Jobs|Headmaster Cat Jobs	고양이 박사 냥코|고양이 대박사|고양이 명예교수
ボンボンネコ|ネコボンのパパ|ネコボンのパパのパパ	土豪弟|土豪爹|土豪爹的爹	Rich Cat III|Rich Cat Sr.|Richest Cat	고양이 도련님|고양이 도령의 파파|고양이 도령의 파파의 파파
見習いスニャイパー|ネゴルゴ|ネゴルゴ３１	狙擊手學徒|貓骷髏|貓骷髏13	Sniper the Recruit|Sniper the Heavy|Sniper the Deadeye	견습생 스냥이퍼|고양고르고|고양고르고31
トゲルガ|トゲランパサラン|デイダラトゲラン	刺骨貓|刺骨白骨貓|山神白骨貓	Togeluga|Togelan Pasalan|Shishilan Pasalan	가시루가|가시란파사란|가시란시시가미
雪だるまのスノーカイ|雪だるまのスノーカイμ|雪妖精のスノーカイμ	雪人騎士・雪白八戒貓|雪人騎士・雪白八戒貓μ|雪妖精・雪白八戒貓μ	Frosty Kai|Frosty Kai, type μ|Frostspirit Kai, type μ	스노우맨의 스노우 카이|스노우맨의 스노우 카이μ|눈의 요정 스노우 카이μ
サンタのメリークウ|サンタのメリークウγ	聖誕樹帝・喜紅悟空貓|聖誕樹帝・喜紅悟空貓γ	Santa Kuu|Santa Kuu, type γ	산타의 메리 쿠우|산타의 메리 쿠우γ
聖夜のシスターカッパー|聖夜のシスターカッパーκ	聖善修女・翡藍悟淨貓|聖善修女・翡藍悟淨貓κ	Holy Coppermine|Holy Coppermine, type κ	성야의 시스터 갓파|성야의 시스터 갓파κ
ネコのプレゼント|ネコプレゼント	聖誕禮物貓|聖誕貓禮物	A Gift of Cats|Cat's Gift	고양이의 선물|고양이 선물
ちびキモネコ|ちび美脚ネコ|ちびムキあしネコ	小小噁心貓|小小美腿貓|小小筋肉美腿貓	Li'l Gross Cat|Li'l Sexy Legs Cat|Li'l Macho Legs Cat	꼬맹이 징글 고양이|꼬맹이 각선미 고양이|꼬맹이 불끈다리 고양이
ちびウシネコ|ちびネコキリン|ちびネコライオン	小小牛貓|小小長頸鹿貓|小小獅子貓	Li'l Cow Cat|Li'l Giraffe Cat|Li'l Lion Cat	꼬맹이 황소 고양이|꼬맹이 고양이 기린|꼬맹이 고양이 라이온
ちびネコノトリ|ちびネコUFO|天空のちびネコ	小小鳥貓|小小UFO貓|小小天空之貓	Li'l Bird Cat|Li'l UFO Cat|Li'l Flying Cat	꼬맹이 고양이 새|꼬맹이 고양이 UFO|꼬맹이 천공의 고양이
死にたてにゃんこ|化けにゃんこ|復活にゃんこ	半死半活貓|幽靈貓|死而復活貓	Undead Cat|Bake-Nyanko|Extra-Life Cat	저세상 냥코|유령 냥코|부활한 냥코
剣士|セーラー服剣士|明王の剣士	劍士|水手服劍士|明王劍士	||	||
騎馬兵|森の騎馬兵|迅雷の黒騎馬兵	騎馬兵|森之騎兵|勇猛黑騎兵	||	||
アシュラ|武者アシュラ|傾奇者アシュラ	阿修羅|武者阿修羅|羅睺阿修羅	||	||
バトルバルーン|海賊バトルバルーン|バトルバルーンUFO	戰鬥熱氣球|海盜戰鬥熱氣球|UFO戰鬥熱氣球	||	||
ドラゴンライダー|ボーンドラゴンライダー|フレイムドラゴンライダー	龍騎士|骨龍騎士|火龍騎士	||	||
プリティキャット|ラブリープリティキャット|サイバープリティキャット	萌貓女|可愛萌貓女|虛擬萌貓女	||	||
サイクロプス|鋼鉄のサイクロプス|時空のサイクロプス	獨眼藍胖|鋼鐵獨眼藍胖|時空獨眼藍胖	||	||
ゴーレム|うさぎゴーレム|ボルケーノゴーレム	巨魔像|巨大兔玩偶魔像|火山巨魔像	||	||
天空神ゼウス|ギガントゼウス|Gギガントゼウス	天空神宙斯|巨神宙斯|G巨神宙斯	Thunder God Zeus|The Majestic Zeus|Almighty Zeus	천공신 제우스|기간트 제우스|G기간트 제우스
守護神アヌビス|パーフェクトアヌビス|Ｇパーフェクトアヌビス	守護神阿努比斯|無瑕神阿努比斯|G無瑕神阿努比斯	Anubis the Protector|Anubis the Unblemished|Almighty Anubis	수호신 아누비스|퍼펙트 아누비스|G퍼펙트 아누비스
美女神アフロディーテ|メガロディーテ|Gメガロディーテ	美女神阿芙蘿黛蒂|大女神美嘉蘿黛蒂|G大女神美嘉蘿黛蒂	Radiant Aphrodite|Megaphrodite|Almighty Aphrodite	미의 여신 아프로디테|메가로디테|G메가로디테
ネコウェイ|ネコドローン|ネコタイムマシン	賽格威貓|無人機貓|時光機貓	Catway|Drone Cat|Time Traveller Cat	냥웨이|고양이 드론|타임머신 고양이
天誅ハヤブサ|斬魔ハヤブサ|滅殺ハヤブサ	天誅飛隼|斬魔飛隼|滅殺飛隼	Hayabusa|Oni Hayabusa|Akuma Hayabusa	천주 송골매|마신 송골매|섬멸 송골매
ニャームス|ネコニャームス	|	|	|
ポチ|タンクポチ	|	|	|
クロミ|クロミとにゃんこたち	|	|	|
せつ子|せつ子Love鯖	|	|	|
ねば～る君|ねば～る君とにゃんこ	|	|	|
ネコタイフーン|ネコハリケーン|ネコあらし	颱風貓|颶風貓|暴風貓	Catornado|Hurricat|Catyphoon	고양이 타이푼|고양이 허리케인|고양이 폭풍
ネコずきんミーニャ|ラブリィずきんミーニャ|覚醒ラブずきんミーニャ	貓紅帽咪娜|蝴蝶結紅帽咪娜|覺醒的蝴蝶結紅帽咪娜	Red Riding Mina|Crimson Mina|Awakened Mina	고양이 냥미|러블리 냥미|각성의 러블리 냥미
幼獣ガオ|皇獣ガオウ	幼獸加歐|皇獸牙王	Baby Gao|Mighty Lord Gao	요수 가오|황수 가오우
狂乱のユキ|狂乱のユキ＆ネコ|狂乱のネコ耳ユキ	狂亂的小雪|狂亂的小雪＆貓咪|狂亂的貓耳小雪	Crazed Yuki|Crazed Yuki & Cat|Crazed Catgirl Yuki	광란의 유키|광란의 유키&고양이|광란의 고양이귀 유키
太陽神アマテラス|テラアマテラス|Gテラアマテラス	太陽神天照|大御神天照|G大御神天照	Shining Amaterasu|Glorious Amaterasu|Almighty Amaterasu	태양신 아마테라스|테라 아마테라스|G테라 아마테라스
繁栄神ガネーシャ|ガネーシャエクサ|Gガネーシャエクサ	象頭神迦內薩|睿智神迦內薩|G睿智神迦內薩	Splendid Ganesha|Exalted Ganesha|Almighty Ganesha	번영신 가네샤|가네샤 엑사|G가네샤 엑사
チアにゃんこ|ネコウエイトレス|にゃんこそば	啦啦隊貓|女侍應貓|送麵貓	Cheerleader Cat|Waitress Cat|Soba Cat	치어리더 냥코|웨이트리스 냥코|러브소바 냥코
トロピカルカリファ|トロピカルXカリファ	熱帶卡莉法|熱帶卡莉法X	Tropical Kalisa|Tropical Kalisa, type X	트로피칼 칼리파|트로피칼X칼리파
真夏のホワイトラビット|真夏のブラックキャット	盛夏白兔女俠|盛夏黑貓女俠	Midsummer Rabbit|Midsummer Cat	한여름의 화이트 래빗|한여름의 블랙 캣
夏色ねねこ|海辺のねねこ|初夏・海辺のねねこ	夏色萌萌貓|海邊萌萌貓|初夏海邊萌萌貓	Sunny Neneko|Seaside Neneko|Early Summer Neneko	여름빛 귀요미|해변의 귀요미|초여름 해변의 귀요미
なめこ|なめこ＆にゃんこ	菇菇|菇菇＆貓咪	Funghi|Funghi 'n' Cat	나메코|나메코＆냥코
なめこタンク|なめこタンク＆にゃんこ	菇菇坦克|菇菇坦克＆貓咪	Tanky|Tanky 'n' Cat	나메코 탱크|나메코 탱크＆냥코
白ネコなめこ|キモ白ネコなめこ	白喵菇菇|噁心白喵菇菇	White Cat|Gross White Cat	흰고양이 나메코|징글 흰고양이 나메코
要塞なめこ|なめこ＆要塞にゃんこ	要塞菇菇|菇菇＆要塞貓咪	Fortressy|Castley	요새 나메코|나메코＆요새냥코
ふてニャン|モミモミふてニャン	|	|	|
ネコ阿波踊り|ネコソーラン|ネコ舞踊ゴージャス	阿波舞貓|素蘭舞貓|金光閃閃舞貓	Awa-Odori Cat|So-Ran Cat|Gorgeous Groovin' Cat	냥코 오도리|냥코 소란|냥코 고저스 삼바
猫飯拳パイパイ|猫飯拳パイパイZ|猫拳王パイパイDX	貓飯拳派派|貓飯拳派派Z|貓拳王派派DX	Pai-Pai|Pai-Pai Z|Pai-Pai DX	묘반권 파이파이|묘반권 파이파이Z|묘권왕 파이파이DX
ネコ特急|ネコ超特急|ネコエクスプレス	貓咪特急|貓咪超特急|貓咪自強號特急	Express Cat|Maglev Cat|Bullet Train Cat	냥코 우등|냥코 특급|냥코 익스프레스
286-1|286-2	狂亂小籠包貓咪|狂亂大籠包貓咪	|	|
閃雷機兵レイ|閃雷機兵プラズマレイ|閃雷輝兵ウイングレイ	閃電機兵飛雷|閃電機兵焰雷|閃電輝兵銀雷	Strike Unit R.E.I.|Assault Unit R.E.I.|Flight Unit R.E.I.	광전기병 레이|광전기병 플라즈마 레이|광전휘병 윙 레이
ネコ球児|ネコリーガー|ネコゴルファー	貓咪球兒|大聯盟貓|高球選手貓	Little Leaguer Cat|Major Leaguer Cat|Golfer Cat	고양이 야구|고양이 리거|고양이 골퍼
鹿目まどか|まどか＆ネコ|アルティメットまどか	鹿目圓|小圓＆貓咪|終極圓	Madoka Kaname|Madoka & Cat|Ultimate Madoka	카나메 마도카|마도카&고양이|얼티밋 마도카
暁美ほむら|ほむら＆ネコ|悪魔ほむら	曉美焰|小焰＆貓咪|惡魔焰	Homura Akemi|Homura & Cat|Devil Homura	아케미 호무라|호무라&고양이|악마 호무라
美樹さやか|さやか＆ネコ	美樹沙耶香|沙耶香＆貓咪	Sayaka Miki|Sayaka & Cat	미키 사야카|사야카&고양이
巴マミ|マミ＆ネコ	巴麻美|麻美＆貓咪	Mami Tomoe|Mami & Cat	토모에 마미|마미&고양이
佐倉杏子|杏子＆ネコ	佐倉杏子|杏子＆貓咪	Kyoko Sakura|Kyoko & Cat	사쿠라 쿄코|쿄코&고양이
キュゥべえ|キュゥべえ＆ネコ	丘比|丘比＆貓咪	Kyubey|Kyubey & Cat	큐베|큐베&고양이
ネコまどか|魔法少女ネコまどか	小圓貓|魔法少女小圓貓	Madoka Cat|Magical Girl Madoka Cat	고양이 마도카|마법소녀 고양이 마도카
ネコほむら|魔法少女ネコほむら	小焰貓|魔法少女小焰貓	Homura Cat|Magical Girl Homura Cat	고양이 호무라|마법소녀 고양이 호무라
ネコさやか|魔法少女ネコさやか	沙耶香貓|魔法少女沙耶香貓	Sayaka Cat|Magical Girl Sayaka Cat	고양이 사야카|마법소녀 고양이 사야카
ネコマミ|魔法少女ネコマミ	麻美貓|魔法少女麻美貓	Mami Cat|Magical Girl Mami Cat	고양이 마미|마법소녀 고양이 마미
ネコ杏子|魔法少女ネコ杏子	杏子貓|魔法少女杏子貓	Kyoko Cat|Magical Girl Kyoko Cat	고양이 쿄코|마법소녀 고양이 쿄코
ちびまどか|ちび魔法少女まどか|ちびアルティメットまどか	小小圓|魔法少女小小圓|究極小小圓	Li'l Madoka|Li'l Magical Girl Madoka|Li'l Ultimate Madoka	꼬마 마도카|꼬마 마법소녀 마도카|꼬마 얼티밋 마도카
ちびほむら|ちび魔法少女ほむら|ちび悪魔ほむら	小小焰|魔法少女小小焰|惡魔小小焰	Li'l Homura|Li'l Magical Girl Homura|Li'l Devil Homura	꼬마 호무라|꼬마 마법소녀 호무라|꼬마 악마 호무라
ネコキュゥべえ|タンクキュゥべえ	丘比貓|坦克丘比	Kyubey Cat|Tank Kyubey Cat	고양이 큐베|탱크 큐베
ネコアイスゴースト|ネコアイスファントム|ネコアイスサキュバス	幽影冰雪貓|幻象冰雪貓|魅魔冰雪貓	Lilith Cat|Succubus Cat|Queen Succubus Cat	고양이 아이스 고스트|고양이 아이스 팬텀|고양이 서큐버스
ネコ屋台|ネコの宅配便|ネコ給食当番	叫賣貓|宅配貓|打飯貓	Food Stall Cat|Delivery Cat|Cafeteria Cat	타코야끼냥|냥택배|고양이 급식당번
帝国陸軍カタパルズ|撃滅戦車ギガパルド|超撃滅戦車ギガパルド|極撃滅戦車ギガパルド	帝國陸軍・石砲隊|擊滅戰車・陸王砲|超擊滅戰車・陸王砲|極擊滅戰車・陸王砲	Mighty Kat-A-Pult|CAT-6 Siege Engine|CAT-8 Behemoth|CAT-10 Gigapult	강철육군 카타바르스|격멸전차 기가파르도|초격멸전차 기가파르도|극격멸전차 기가파르도
古代軍船ガレーズ|無敵艦隊シーガレオン|超無敵艦隊シーガレオン|極無敵艦隊シーガレオン	古代軍船・戰槳隊|無敵艦隊・海皇錐|超無敵艦隊・海皇錐|極無敵艦隊・海皇錐	Mighty Drednot|B.C.S. Lionheart|B.C.S. Tigerclaw|B.C.S. Beartooth	고대군함 가레스|무적함대 시갈레온|초무적함대 시갈레온|극무적함대 시갈레온
飛空襲撃ボンバーズ|飛行戦艦ボルボンバー|超飛行戦艦ボルボンバー	飛空襲擊・轟炸隊|飛行戰艦・空帝雷|超飛行戰艦・空帝雷	Mighty Bomburr|NEK-0 Sky Fortress|NEK-02 Air Citadel	비행습격 바머스|비행전함 보르본|초비행전함 보르본바
ネコジャンパー|ネコボールター|ネコ奥様	業餘撐杆跳貓|職業撐杆跳貓|全職家庭主婦貓	Vaulter Cat|Polevaulter Cat |Housewife Cat 	고양이 점퍼|고양이 장대|고양이 빨래봉
ネコバサミ|ネコチェーンソー|草刈りネコ	樹剪貓|電鋸貓|割草貓	Gardener Cat|Lumbercat|Weedwacker Cat	고양이 가위|고양이 톱|고양이 풀베기
ネコ博士|ネコ博士＆ネコ	|	|	|
ネコナースキャンドル|ネコナースマリア|ネコナースサンタマリア	聖燭貓護士|聖母貓護士|聖母瑪利亞貓護士	Yuletide Nurse|Yule Knight Nurse|Xmas Spirit Nurse	고양이 간호사 캔들|고양이 간호사 마리아|고양이 간호사 산타마리아
ちびネコフィッシュ|ちびネコクジラ|ちびネコ島	小小魚貓|小小鯨貓|小小島貓	Li'l Fish Cat|Li'l Whale Cat|Li'l Island Cat	꼬맹이 고양이 피쉬|꼬맹이 고양이 고래|꼬맹이 고양이 섬
ちびネコトカゲ|ちびネコドラゴン|ちびネコキングドラゴン	小小蜥蜴貓|小小龍貓|小小龍王貓	Li'l Lizard Cat|Li'l Dragon Cat|Li'l King Dragon Cat	꼬맹이 고양이 도마뱀|꼬맹이 고양이 드래곤|꼬맹이 고양이 킹드래곤
ちび巨神ネコ|ちびネコダラボッチ|ちびネコジャラミ	小小巨神貓|小小巨人貓|小小賈拉米貓	Li'l Titan Cat|Li'l Mythical Titan|Li'l Jamiera Cat	꼬맹이 거신 고양이|꼬맹이 고양이 다라보치|꼬맹이 고양이 쟈라미
大掃除ねねこ|初詣ねねこ|新春・初詣ねねこ	大掃除萌萌貓|喜氣洋洋萌萌貓|新年新衣萌萌貓	Years-End Neneko|New Year Neneko|Festive New Year Neneko	대청소 귀요미|신정의 귀요미|신춘 신정의 귀요미
ピコ太郎|ネコ太郎	PIKO太郎|貓咪太郎	PIKOTARO|NEKOTARO	피코 타로|고양이 타로
海王神ポセイドン|ポセイドラグーン|Gポセイドラグーン	海王神波塞頓|海龍騎波塞頓|G海龍騎波塞頓	Wrathful Poseidon|Valiant Poseidon|Almighty Poseidon	해왕신 포세이돈|포세이도라군|G포세이도라군
CPAC|PPAP	CPAC|PPAP	CPAC|PPAP	CPAC|PPAP
巫女姫ミタマ|白無垢のミタマ	巫女姬御靈|白無垢御靈	Miko Mitama|Mitama the Oracle	무녀공주 미타마|순백의 미타마
殺意のネコ|真・殺意のネコ|改心のネコ	殺意貓|真・殺意貓|改過向善貓	Killer Cat|True Killer Cat|Radical Cat	살의의 고양이|독기의 고양이|개심의 고양이
321_1|321_2|321_3	三原慧悟|一二三～原偶像貓|偶像三原＆貓咪	||	||
ナゾウサギ|兎宮王道	|	|	|
さるかに合戦|爆音楽奏サルカニヘヴン|超音楽奏サルカニフェス	猴蟹大戰貓|爆音樂奏猴蟹天團|超音樂奏猴蟹天團	Sarukani|Rock Revengers|The One-Hit Wonders	떠돌이 악사|폭주 락밴드 몽키헤븐|질주 락밴드 몽키헤븐
宮木武蔵|主演 宮木武蔵|覚醒 宮木武蔵	宮木武藏|主演　宮木武藏|覺醒　宮木武藏	Miyamoku Musashi|Heroic Musashi|Awakened Musashi	무사시|주연 무사시|각성의 주연 무사시
ネコストーン|ネコクリーナー|ネコカメカー	冰壺貓|地板清潔機器貓|貓咪烏龜車	Curling Cat|Zamboney Cat|Green Shell Cat	고양이 스톤|고양이 클리너|고양이 거북 카
ネコボクサー|ネコチャンピオン|ネコリベンジ	拳擊手貓|拳擊冠軍貓|復仇貓	Welterweight Cat|Heavyweight Cat|Ectoweight Cat	고양이 복서|고양이 챔피온|고양이 리벤지
メビウス|奇跡の調和メビウス	莫比烏斯|奇蹟調和莫比烏斯	Mobius|Miraculous Mobius	뫼비우스|기적의 조화 뫼비우스
ベリアル|猛進の大逆者ベリアル	貝利亞|猛進大叛徒貝利亞	Belial|Reckless Belial	벨리알|맹진하는 대반역자 벨리알
ハッピー100|幸せ連鎖子ハッピー100	哈皮100|幸福連鎖哈皮100	Happy 100|Heartful Happy 100	해피100|행복 연쇄소녀 해피100
ネコエッグ|ネコエッグ２|ネコエッグ３	彩蛋貓|彩蛋貓之２|彩蛋貓之３	Eggy Cat|Easter Cat|Easter Egg Cat	고양이 에그|고양이 에그2|고양이 에그3
上杉謙信・春|上杉謙信・春爛漫|上杉謙信・春うらら	上杉謙信・春|上杉謙信・春爛漫|上杉謙信・春光明媚	Springtime Kenshin|Full-Bloom Kenshin|Spring Breeze Kenshin	봄의 사라만다|만개의 사라만다|봄나들이 사라만다
道化師エッグダック|闇道化サイコダック|極悪道化マッドダック	彩蛋師白鴨小丑|闇蛋師黑鴨小丑|極惡蛋師怪鴨小丑	Bunny & Canard|Disciple Psychoduck|Malevolent Mad-Duck	클라운 에그덕|다크 사이코덕|극악 클라운 매드 덕
イースターねねこ|イースターバニーねねこ|開花・イースターバニーねねこ	復活節萌萌貓|復活節兔萌萌貓|花開復活節兔萌萌貓	Easter Neneko|Hoppity Neneko|Blossoming Neneko	이스타 귀요미|이스타바니 귀요미|개화・이스타바니 귀요미
黒獣ガオウ|皇獣ガオウダーク	黑獸牙王|皇獸黑暗牙王	Shadow Gao|Diabolic Gao	흑수 가오우|황수 가오우 다크
狐娘ヒメユリ|九尾の狐姫ヒメユリ|豊穣の狐姫ヒメユリ	俏狐娘百荷|九尾魅狐姬百荷|豐穰的狐姬百荷	Trickster Himeyuri|Himeyuri Ninetails|Fox Queen Himeyuri	여우아가씨 하늘나리|구미호공주 하늘나리|풍요의 여우공주 하늘나리
人魚娘ルリィ|宝玉の人魚姫ルリィ|竜宮の人魚姫ルリィ	美人魚琉璃|珍珠人魚姬琉璃|龍宮人魚姬琉璃	Sea Maiden Ruri|Sea Mistress Ruri|Mer-Queen Ruri	인어아가씨 루리|인어공주 루리|용궁의 인어공주 루리
ミイラ娘レイカ|玉座のミイラ姫レイカ|黄金のミイラ姫レイカ	木乃伊梨香|寶座法老姬梨香|黃金法老姬梨香	Queen Reika|Pharaoh Reika|Eternal Reika	미라아가씨 레이카|미라공주 레이카|황금의 미라공주 레이카
プリンセスケリ姫号|プリンセスケリ姫号CC|プレミアムケリ姫号CC	飛踢公主號|飛踢公主號CC|豪華飛踢公主號CC	HMS Princess|HMS Princess CC|HMS Princess II CC	프린세스 발차기 공주호|프린세스 발차기 공주호CC|프리미엄 발차기 공주호CC
今川義元|武神・今川義元|燐火の武神・今川義元	今川義元|武神・今川義元|鬼火武神・今川義元	Imagawa Yoshimoto|Wargod Yoshimoto|Immortal Yoshimoto	누아다|분노의 누아다|화염의 누아다
340_1			
赤髪のゆきにゃん|赤髪のビューティゆきにゃん|赤髪のビューティムキにゃん	紅髮小雪貓|紅髮美腿小雪貓|紅髮筋肉美腿小雪貓	Redhead Yuki Cat|Redhead Lovely Yuki Cat|Redhead Muscled Yuki Cat	빨간 머리 고양이 유키|빨간 머리 뷰티 고양이 유키|빨간 머리 불끈 고양이 유키
失われし世界のユキ|失われし世界のユキ＆ネコ|失われし世界のネコ耳ユキ	失去世界的小雪|失去世界的小雪＆貓咪|失去世界的貓耳小雪	Lost World Yuki|Lost World Yuki ＆ Cat|Lost World Catgirl Yuki	잃어버린 세계의 유키|잃어버린 세계의 유키&고양이|잃어버린 세계의 고양이귀 유키
ネコまねき|ネコまねき・寿	招財貓|貓神抱稻	Maneki Cat|Neo Maneki Cat	은혜갚는 고양이|축복 고양이
なめネコ|ネコなめ	鼻涕蟲與貓|鼻涕蟲騎貓	Slug Jockey Cat|Slugcat	민달팽이 고양이|고양이 민달팽이
オルトス|オルトスCC|彩色のオルトスCC	奧爾托斯|奧爾托斯CC|彩色的奧爾托斯CC	Orthos|Orthos CC|Artist Orthos CC	오르토스|오르토스CC|채색의 오르토스CC
ミシェリア|ミシェリアCC|午睡のミシェリアCC	米希利亞|米希利亞CC|午睡的米希利亞CC	Michelia|Michelia CC|Naptime Michelia CC	미세리아|미세리아CC|낮잠의 미세리아CC
とどめき|とどめきCC	留姬|留姬CC	Todomeki|Todomeki CC	토도메키|토도메키CC
ぐでたまにゃんこ|ぐでオムにゃんこ|ぐでベネにゃんこ	蛋黃貓|蛋包飯貓|班尼迪克蛋黃貓	||	구데타마 냥코|구데오므 냥코|구데베네 냥코
ぐでたまプレート|ぐでたまベーコンプレート	來盤蛋黃哥|來盤培根蛋黃哥	|	구데타마 플레이트|구데타마 베이컨
ぐでぐでプリン|ぐでぐでアラモード	慵懶布丁蛋黃哥|焦糖布丁蛋黃哥	|	구데구데 푸딩|구데구데 아라모드
ニセたま軍団|ネコニセたま軍団	蛋黃人軍團|貓咪蛋黃人軍團	|	니세타마 군단|니세타마 냥코군단
双掌星のシシル＆コマリ|双掌星のシシル＆コマリΦ|双輝星のシシル＆コマリΦ	雙掌星西兒＆小毬|雙掌星西兒＆小毬Φ|雙輝星西兒＆小毬Φ	Twinstars|Twinstars, type Φ|Divine Twinstars	시시루와 코마리|시시루와 코마리Φ|쌍둥이별 시시루와 코마리Φ
ネコ仙人|ネコ老師|仮面のネコ仙人	貓咪仙人|貓咪老仙|假面的貓咪仙人	Hermit Cat|Grandmaster Cat|Masked Grandmaster Cat	고양이 신선|고양이 노사|가면의 고양이 신선
チョコレート|チョコレート進化|354_3	貓奴巧克力|貓咪與巧克力|貓化巧克力	||	||
常夏の果実カイ|常夏の果実カイμ	常夏果實八戒貓|常夏果實八戒貓μ	Seashore Kai|Seashore Kai, type μ	여름의 카이|여름의 카이μ
観測兵器ガリレオ|時空基地アルマゲドン|超時空基地アルマゲドン	觀測兵器・探天隊|時空基地・星隕爆|超時空基地・星隕爆	Mighty Rekon Korps|Orbital Platform Armageddon|Orbital Annihilator Ragnarok	관측병기 갈릴레오|시공기지 아마겟돈|초시공기지 아마겟돈
ノラ|覚醒ノラ	|	|	|
狼娘ディル|虚飾の狼姫ディル|道化の狼姫ディル	狼來妹迪兒|虛榮小狼女迪兒|小丑女狼迪兒		Wolfchild Deale|Wolf Princess Deale|Jester Queen Deale	늑대아가씨 딜|늑대공주 딜|도화의 늑대공주 딜
ゾンビ娘ヴェルヴェーヌ|死霊の花嫁ヴェルヴェーヌ|満腹の花嫁ヴェルヴェーヌ	不死女薇薇|死靈新嫁娘薇薇|滿腹新嫁娘薇薇	Graveflower Verbena|Verbena the Bride|Opulent Verbena 	좀비아가씨 버베나|사령의 신부 버베나|행복한 신부 버베나
火の精霊メララ|火炎の精霊メラバーン|火炎の精霊王メラバーニング|火炎の大精霊メラフェニックス	火精靈梅拉|火焰精靈梅拉邦|火焰精靈王猛火梅拉邦|火焰大精靈浴火梅拉邦	Bora|Bazibon|Bazibastra|Bazifenix	불의 정령 메라라|불꽃의 정령 메라란|불꽃의 정령왕 메라버닝|불꽃의 대정령 메라피닉스
水の精霊ミズリィ|流水の精霊ミズマリン|流水の精霊王ミズマリリン	水精靈密茲|流水精靈密茲曼|流水精靈王激流密茲曼	Mizli|Marinmizu|Mizuririn	물의 정령 마리|유수의 정령 마리린|유수의 정령왕 마리리린
風の精霊エアル|嵐の精霊エアフワン|嵐の精霊王エアフワンテ|嵐の大精霊エアフワンティ	風精靈艾爾|暴風精靈艾爾方|暴風精靈王艾爾方帝|暴風大精靈艾爾方大帝	Aer|Erphuan|Aervanta|Aervantex	바람의 정령 에어리|폭풍의 정령 에어린|폭풍의 정령왕 에어리린|폭풍의 대정령 에어리얼 
セイバー|セイバーCC|セイバーオルタCC	Saber|Saber CC|Saber Alter CC	Saber|Saber CC|Saber Alter CC	세이버|세이버 CC|세이버 오르타CC
遠坂 凛|遠坂 凛CC	遠坂凜|遠坂凜CC	Rin Tohsaka|Rin Tohsaka CC	토오사카 린|토오사카 린CC
イリヤスフィール|イリヤスフィールCC	伊莉雅蘇菲爾|伊莉雅蘇菲爾CC	Illyasviel|Illyasviel CC	이리야스필|이리야스필CC
アーチャー|アーチャーCC	Archer|Archer CC	Archer|Archer CC	아처|아처CC
ランサー|ランサーCC	Lancer|Lancer CC	Lancer|Lancer CC	랜서|랜서CC
ライダー|ライダーCC	Rider|Rider CC	Rider|Rider CC	라이더|라이더CC
ギルガメッシュ|ギルガメッシュCC	Gilgamesh|Gilgamesh CC	Gilgamesh|Gilgamesh CC	길가메쉬 |길가메쉬CC
ネコセイバー|英霊ネコセイバー|ネコセイバーオルタ	貓Saber|英靈貓Saber|貓Saber Alter	Saber the Cat|Heroic Spirit Saber Cat|Saber Alter Cat	고양이 세이버|영령 고양이 세이버|고양이 세이버 오르타
ネコ桜|エプロンネコ桜|夢見るネコ桜	貓咪櫻|穿圍裙的貓咪櫻|有夢想的貓咪櫻	Sakura the Cat|Apron Sakura Cat|Dreaming Sakura Cat	고양이 사쿠라|앞치마 고양이 사쿠라|꿈꾸는 고양이 사쿠라
ネコ凛|魔術師ネコ凛	貓咪凜|魔術師貓咪凜	Rin the Cat|Mage Rin Cat	고양이 린|마술사 고양이 린
ネコイリヤ|雪の妖精ネコイリヤ	伊莉雅貓|雪中妖精伊莉雅貓	Illya the Cat|Snow Faerie Illya	고양이 이리야|눈의 요정 고양이 이리야
ちび士郎|ちび士郎CC	小小士郎|小小士郎CC	Li'l Shirou|Li'l Shirou CC	꼬마 시로|꼬마 시로CC
ちび桜|ちび桜CC	小小櫻|小小櫻CC	Li'l Sakura|Li'l Sakura CC	꼬마 사쿠라|꼬마 사쿠라CC
記念ネコ|記念ネコビルダー	紀念幣貓|紀念幣健美貓	Coin Cat|Macho Coin Cat	기념주화 고양이|기념주화 고양이 빌더
ネコ探査機|ネコサーチMkⅡ|ネコサテライト	貓咪探測器|智能BB貓MkⅡ|衛星貓	Rover Cat|Rover Cat Mk II|Catellite	고양이 탐사기|고양이 서치MkⅡ|고양이 위성
ネコフェンシング|ネコ剣道|自由のネコ	擊劍貓|劍道貓|自由貓神	Fencer Cat|Kendo Cat|The Kitty of Liberty	고양이 펜싱|고양이 검도|자유의 고양이
黒無垢のミタマ|黒蝶のミタマダーク	黑無垢御靈|深靛黑蝶御靈	Dark Mitama|Gothic Mitama	칠흑의 미타마|흑첩의 미타마
ネコバレー|ネコバレエ|ネコカレー	排球貓|芭蕾貓|咖哩貓	Volley Cat|Ballet Cat|Curry Cat	고양이 배구|고양이 발레리나|고양이 카레
幼傑ダルターニャ|英傑ダルターニャ	幼傑達太貓|英傑達太貓	D'artanyan|Meow-sketeer	쾌걸 달타냥|영걸 달타냥
ねこ農家|ねこカブ農家	農人貓|蕪菁農家貓	Farmer Cat|Harvest Cat	고양이 농가|고양이 순무농가
ガラスネコ|ガラスネコビルダー|クリスタルネコビルダー	玻璃貓|玻璃健美貓|水晶健美貓	Glass Cat|Macho Glass Cat|Macho Crystal Cat	유리 고양이|유리 고양이 빌더|크리스탈 고양이 빌더
謎仮面のウララー|ネコ仮面のウララー|ネコ神面のウララー	神秘假面烏拉拉|貓咪假面烏拉拉|貓神面烏拉拉	Masked Yulala|Mystic Yulala|Spiritual Yulala	수수께끼의 가면 우라라|고양이 가면 우라라|고양이 가면신 우라라
氷上聡里＆ネコ|氷上聡里＆ネコCC	冰上聰里＆貓咪|冰上聰里＆貓咪CC	Satori Hikami & Cat|Satori Hikami & Cat CC	히카미 사토리&냥코|히카미 사토리&냥코CC
矢部明雄|矢部明雄CC|矢部＆ガンダーロボCC	矢部明雄|矢部明雄CC|矢部＆剛達機器人CC	Akio Yabe|Akio Yabe CC|Akio & Gunder CC	야베 아키오|야베 아키오CC|야베&건다로보CC
虹谷彩理|虹谷彩理CC	虹谷彩理|虹谷彩理CC	Sairi Nijitani|Sairi Nijitani CC	니지타니 사이리|니지타니 사이리CC
紺野美崎|紺野美崎CC	紺野美崎|紺野美崎CC	Misaki Konno|Misaki Konno CC	콘노 미사키|콘노 미사키CC
片桐恋|片桐恋CC	片桐戀|片桐戀CC	Ren Katagiri|Ren Katagiri CC	카타기리 렌|카타기리 렌CC
猫塚かりん|猫塚かりんCC	貓塚花凜|貓塚花凜CC	Karin Nekozuka|Karin Nekozuka CC	네코즈카 카린|네코즈카 카린CC
早川あおい|早川あおいCC|野球マン１号CC	早川蒼|早川蒼CC|野球人1號CC	Aoi Hayakawa|Aoi Hayakawa CC|Baseball Mask α	하야카와 아오이|하야카와 아오이CC|야구맨 1호CC
橘みずき|橘みずきCC|野球マン２号CC	橘水月|橘水月CC|野球人2號CC	Mizuki Tachibana|Mizuki Tachibana CC|Baseball Mask β	타치바나 미즈키|타치바나 미즈키CC|야구맨 2호CC
六道聖|六道聖CC|野球マン３号CC	六道聖|六道聖CC|野球人3號CC	Hijiri Rokudo|Hijiri Rokudo CC|Baseball Mask γ	로쿠도 히지리|로쿠도 히지리CC|야구맨 3호CC
新島早紀|新島早紀CC|サンバ新島早紀CC	新島早紀|新島早紀CC|森巴新島早紀CC	Saki Nijima|Saki Nijima CC|Samba Saki CC	니지마 사키|니지마 사키CC|삼바 니지마 사키CC
星井スバル|星井スバルCC|暗黒スバルCC	星井昴|星井昴CC|暗黑昴CC	Subaru Hoshi|Subaru Hoshi CC|Dark Subaru CC	호시이 스바루|호시이 스바루CC|암흑 스바루CC
小山雅|小山雅CC|野球マン５号CC	小山雅|小山雅CC|野球人5號CC	Miyabi Oyama|Miyabi Oyama CC|Baseball Mask δ	오야마 미야비|오야마 미야비CC|야구맨 5호CC
古龍ガングリオン|古龍王ガングリオン|古龍皇帝ガングリオン	古龍剛格利昂|古龍王剛格利昂|古龍皇剛格利昂	Ganglion|Ganglion the Ancient|Ganglion the Unleashed	고룡 강글리온|고룡왕 강글리온|고룡황제 강글리온
風隼さくら|JK風隼さくら|天誅・風隼さくら|天誅Z・風隼さくら	風隼櫻|女高生風隼櫻|天誅・風隼櫻|天誅Z・風隼櫻	Sakura Sonic|Afterschool Sakura|Sacred Blade Sakura|Sacred Blade Sakura Z	사쿠라|JK사쿠라|천주 사쿠라|천주Z 사쿠라
ハニトンくん|ハニトンくん＆にゃんこ	|	|	|
めんトリ|めんトリCC	懶得鳥|懶得鳥CC	Mentori|Mentori CC	Mentori|Mentori CC
イモウト|イモウトCC	直白妹|直白妹CC	Imoto|Imoto CC	Imoto|Imoto CC
雷の精霊ボルト|天雷の精霊ピカボルト|天雷の精霊王ギガボルト	雷精靈波特|天雷精靈皮卡波特|天雷精靈王基加波特	Voli|Volta|Gigavolta	번개의 정령 볼트|벼락의 정령 피카볼트|벼락의 정령왕 기가볼트
ちびシンジ|プラグスーツのちびシンジ|黒プラグスーツのちびシンジ	小小真嗣|作戰服小小真嗣|黑色作戰服小小真嗣	Shinji & Cat|Plug Suit Shinji|Plug Suit Shinji Black	꼬맹이 신지|플러그 슈트 꼬맹이 신지|다크 플러그 슈트 꼬맹이 신지
ネコゲンドウ＆ネコ冬月|月のネコゲンドウ＆ネコ冬月	源堂貓與冬月貓|月之源堂貓＆冬月貓	Gendo & Fuyutsuki Cats|Moon Gendo & Fuyutsuki Cats	고양이 겐도&후유츠키|달의 고양이 겐도&후유츠키
ネコキリン初号機|ネコキリン２号機	長頸鹿貓初號機|長頸鹿貓2號機	Giraffe Unit-01|Giraffe Unit-02	기린 고양이 초호기|기린 고양이 2호기
ちびカヲル|プラグスーツのちびカヲル|月の少年ちびカヲル	小小薰|作戰服小小薰|月下少年薰	Kaworu & Cat|Plug Suit Kaworu|Moon Kaworu	꼬맹이 카오루|플러그 슈트 꼬맹이 카오루|달의 소년 꼬맹이 카오루
ネコレイ|ネコアヤナミレイ（仮称）	零貓|綾波零貓（暫稱）	Rei Cat|Ayanami Cat (TBC)	고양이 레이|고양이 아야나미 레이 (가칭)
ネコアスカ|エプロンネコアスカ	明日香貓|圍裙明日香貓	Asuka Cat|Apron Asuka	고양이 아스카|에이프런 고양이 아스카
ネコマリ|極秘入国ネコマリ	真理貓|秘密入境真理貓	Mari Cat|Special Ops Mari	고양이 마리|극비입국 고양이 마리
ちびレイ|プラグスーツのちびレイ|再会のちびレイ	小小零|作戰服小小零|重逢的小小零	Rei Ayanami|Plug Suit Rei|Reunion Li'l Rei	꼬맹이 레이|플러그 슈트 꼬맹이 레이|재회의 꼬맹이 레이
ちびアスカ|プラグスーツのちびアスカ|眼帯のちびアスカ	小小明日香|作戰服小小明日香|眼罩小小明日香	Asuka Langley|Plug Suit Asuka|Eyepatch Li'l Asuka	꼬맹이 아스카|플러그 슈트 꼬맹이 아스카|안대 꼬맹이 아스카
ちびマリ|プラグスーツのちびマリ	小小真理|作戰服小小真理	Mari Illustrious|Plug Suit Mari	꼬맹이 마리|플러그 슈트 꼬맹이 마리
エヴァ零号機|エヴァ零号機＆ネコ	EVA零號機|EVA零號機&貓咪	Eva Unit-00|Eva Unit-00 & Cat	에바 영호기|에바 영호기&고양이
エヴァ初号機|エヴァ初号機＆ネコ|決意のエヴァ初号機＆ネコ	EVA初號機|EVA初號機&貓咪|決意的EVA初號機&貓咪	Eva Unit-01|Eva Unit-01 & Cat|Determined Unit-01 & Cat	에바 초호기|에바 초호기&고양이|결의의 에바 초호기&고양이
エヴァ２号機|エヴァ２号機＆ネコ|エヴァ改２号機コード７７７	EVA2號機|EVA2號機&貓咪|EVA改2號機 Code 777	Eva Unit-02|Eva Unit-02 & Cat|Unit-02, Code 777	에바 2호기|에바 2호기&고양이|에바 개 2호기 코드777
ネコシンジ|ネコトウジ＆ネコケンスケ	真嗣貓|冬二貓&劍介貓	Shinji Cat|Toji & Kensuke Cats	고양이 신지|고양이 토우지&켄스케
ゼロムーンオペレーターズ|ファーストムーンネルフ	通訊聯絡機零月|作戰指揮機初月	Moon Operators|NERV Moon	제로문 오퍼레이터즈|퍼스트문 NERV
温泉天国テルマエ|地底戦隊グランドン|超地底戦隊グランドン	溫泉天堂・浴場隊|地底戰隊・土龍鑽|超地底戰隊・土龍鑽	Mighty Thermae D-Lux|Subterra Guardians|Subterra Sentinels	온천천국 테르마이|지하전대 그란돈|초지하전대 그란돈
狂乱のもねこ|狂乱のスターもねこ	狂亂萌貓|狂亂偶像萌貓	Crazed Moneko|Corrupted Moneko	광란의 귀여미|광란의 스타 귀여미
ポコタ|ポコタＣＣ	POKOTA|POKOTA CC	Pokota|Pokota CC	POKOTA|POKOTA CC
オビス|オビスＣＣ	OVIS|OVIS CC	Ovis|Ovis CC	OVIS|OVIS CC
ココ|ココＣＣ	COCO|COCO CC	Coco|Coco CC	COCO|COCO CC
太秦萌＆ネコ|太秦萌＆ネコＣＣ	|	|	|
松賀咲＆ネコ|松賀咲＆ネコＣＣ	|	|	|
小野ミサ＆ネコ|小野ミサ＆ネコＣＣ	|	|	|
太秦麗＆ネコ|太秦麗＆ネコＣＣ	|	|	|
ぶんぶんネコライダー|ぶんぶんロボライダー|ぶんぶんネコライダーL	噴噴貓騎士|機械噴噴騎士|噴噴貓騎士L號	Mecha-Bun|Mecha-Bun Mk II|Ultimate Mecha-Bun	고양이 라이더 맴매|로봇 라이더 맴매|고양이 라이더 맴매-L
ネコクエスト|ネコクエストXI|ネコクエストXI-2	貓咪鬥惡龍|貓咪鬥惡龍XI|貓咪鬥惡龍XI-2	Cat Clan Heroes|Cat Guild Heroes|Cat Quest Heroes	고양이 퀘스트|고양이 퀘스트XI|고양이 퀘스트XI-2
そうまにゃん|スマートそうまにゃん	蒼真貓|瀟灑蒼真貓	Souma Cat|Stylish Souma Cat	고양이 소우마|스마트 고양이 소우마
オタネコギーク|ギークネコハッカー	祖克柏貓|駭客祖克柏貓	Otaku Geek Cat|Hacker Geek Cat	오덕 고양이 긱|고양이 해커 긱
ぐでネコマシン|ぐでネコマシン・卵	蛋黃機器貓|蛋黃機器貓・蛋	|	구데 냥코 머신|구데 냥코 머신・알
亡者探偵ヴィグラー|魔界探偵グラヴィー|魔神探偵グラヴィティー|聖魔探偵ゼログラヴィティー	亡者偵探吳仲力|魔界偵探吳仲力|魔神偵探吳仲力|聖魔偵探吳仲力	Detective Vigler|Inspector Gabriel|Section Chief Gravicci|Arcane Commissioner Gravicci	망자탐정 비그라|마계탐정 그라비|마신탐정 그라티비|성마탐정 제로그라티비
433_1|433_2	賤萌熊|賤萌黑熊	Betakkuma|Black Betakkuma	적극적인 곰|블랙 적극적인 곰
434_1|434_2	賤萌貓|殺意賤萌貓	Nekokkuma|Killer Nekokkuma	냥코쿠마|살의의 냥코쿠마
白にゃんこ剣士|黒にゃんこ剣士	白貓劍士|黑貓劍士	|	|
ちびネコヴァルキリー|ちびネコヴァルキリー・華	小小瓦爾基麗貓|寶島瓦爾姬娘	Li'l Valkyrie|Wind Dancer Valkyrie	꼬마 고양이 발키리|소녀 고양이 발키리
ノビルガ|ノビランパサラン|ノビランターバン	捲捲貓|捲捲白骨貓|頭巾捲捲白骨貓	Nobiluga|Nobilan Pasalan|Mystican Pasalan	노비루가|노비란파사란|노비란 터번
激・神さま|超・神さま|超・神さまゴールデン	激・神|超・神|超・金光閃閃神	Cat God the Great|Cat God the Awesome|Cat God the Golden	격・신|초・신|초・신 골든
灼熱のビーチクウ|灼熱のビーチクウγ	灼熱海灘悟空貓|灼熱海灘悟空貓γ	Waverider Kuu|Waverider Kuu, type γ	불타는 해변의 쿠우|불타는 해변의 쿠우γ
時空神クロノス|クロノストリガー|Gクロノストリガー	時空神克羅諾絲|時空之鑰克羅諾絲|G時空之鑰克羅諾絲	Empress Chronos|Chronos the Infinite|Almighty Chronos	시간의 신 크로노스|크로노스 트리거|G크로노스 트리거
ベベ|なぎさ&ネコ|円環の理の使者なぎさ	蓓蓓|小渚＆貓咪|圓環之理的使者渚	Bebe|Nagisa & Cat|Law of Cycles Nagisa	베베|나기사&고양이|원환의 이치의 사자 나기사
影傑ダークダルターニャ|黒傑ダークダルターニャ	影傑漆黑達太貓|闇傑漆黑達太貓	D'arktanyan|Valiant D'arktanyan	호걸 달타냥|흑걸 달타냥
子連れにゃんこ|ネコワゴンサービス|ネコバケーション	帶子貓|推車攤販貓|行李推車貓	Lone Cat and Kitten|Vendor Cat and Kitten|Tourist Cat	유모차 고양이|음료 카트 고양이|바캉스 고양이
戦隊ドリラ|戦隊パワードリラ|シン・パワードリラ	地底戰隊・地殼鑽|地底戰隊・強力地殼鑽|正宗・強力地殼鑽	Driller Cat|Power Driller Cat|Neo Driller Cat	전대 드릴러|전대 파워 드릴러|신 파워 드릴러
戦隊ウチコンガ|戦隊パワーウチコンガ|シン・パワーウチコンガ	地底戰隊・木樁釘|地底戰隊・強力木樁釘|正宗・強力木樁釘	Piledriver Cat|Power Piledriver Cat|Neo Piledriver Cat	전대 드라이버|전대 파워 드라이버|신 파워 드라이버
戦隊チョキンドス|戦隊パワーチョキンドス|シン・パワーチョキンドス	地底戰隊・大力鉗|地底戰隊・強力大力鉗|正宗・強力大力鉗	Cutter Cat|Power Cutter Cat|Neo Cutter Cat	전대 커터 고양이|전대 파워 커터 고양이|신 파워 커터 고양이
戦隊ショベリン|戦隊パワーショベリン|シン・パワーショベリン	地底戰隊・貓怪手|地底戰隊・強力貓怪手|正宗・強力貓怪手	Backhoe Cat|Power Backhoe Cat|Neo Backhoe Cat	전대 포클레인 고양이|전대 파워 포클레인 고양이|신 파워 포클레인 고양이
戦隊チャッソ|戦隊パワーチャッソ|シン・パワーチャッソ	地底戰隊・電鋸手|地底戰隊・強力電鋸手|正宗・強力電鋸手	Miter Saw Cat|Power Saw Cat|Neo Saw Cat	전대 직쏘고양이|전대 파워 직쏘고양이|신  파워 직쏘고양이
宮本武蔵|剣神・宮本武蔵|無双の剣神・宮本武蔵	宮本武藏|劍神・宮本武藏|無雙劍神・宮本武藏	Musashi Miyamoto|Wargod Miyamoto|Immortal Miyamoto	무사시|검신 무사시|무쌍의 검신 무사시
聖会長ジャンヌダルク|聖会長ジャンヌダルクψ	聖女貓會長貞德|聖女貓會長貞德ψ	Headmistress Jeanne|Headmistress Jeanne ψ	잔다르크|잔다르크ψ
天城龍バベル|魔城龍バベル|天魔城龍バベル	天龍城巴比貓塔|魔城龍巴比貓塔|天魔城龍巴比貓塔	High Lord Babel|Babel the Darkflame|God-Emperor Babel	천성용 바벨|마성용 바벨|천마성용 바벨
うしわか丸|巨大神兵ベンケイ	貓若丸|巨大神兵弁慶	Ushiwakamaru|Colossal Benkei	리코더 고양이|해머 고양이
古代ネコ|現代ネコ|未来ネコ	古代貓|現代貓|未來貓	Primordial Cat|Modern Cat|Future Cat	고대 고양이|현대 고양이|미래 고양이
きたろう|ゲゲゲの鬼太郎	|	|	|
目玉おやじ|入浴おやじ	|	|	|
ワンダー・モモコ|キューティー・モモコ	花漾桃子|甜心桃子	Wonder MOMOCO|Cutie MOMOCO	원더 모모코|큐티 모모코
間桐 桜|間桐 桜CC|黒桜CC	間桐櫻|間桐櫻CC|黑櫻CC	Sakura Matou|Sakura Matou CC|Dark Sakura CC	마토 사쿠라|마토 사쿠라CC|흑화 사쿠라CC
ネコ士郎|魔術師見習いネコ士郎	士郎貓|實習魔術師士郎貓	Shirou the Cat|Novice Mage Shirou Cat	고양이 시로|마술사 견습생 고양이 시로
アーチャーネコ|英霊アーチャーネコ	Archer貓|英靈Archer貓	Archer the Cat|Heroic Spirit Archer Cat	아처 고양이|영령 아처 고양이 
ネコライダー|英霊ネコライダー	Rider貓|英靈Rider貓	Rider the Cat|Heroic Spirit Rider Cat	고양이 라이더|영령 고양이 라이더
ネコ言峰＆ネコギルガメッシュ|ネコギルガメッシュ＆ネコ言峰	言峰貓&吉爾伽美什貓|吉爾伽美什貓&言峰貓	Kotomine & Gilgamesh Cats|Gilgamesh & Kotomine Cats	고양이 고토미네 & 고양이 길가메쉬 |고양이 길가메쉬 & 고양이 고토미네
レジェルガ|レジェランパサラン	奇幻貓|奇幻白骨貓	Legeluga|Legelan Pasalan	레제루가|레제란 파사란
フィリバスターX|フィリバスターY|メタフィリバスター	議事阻撓貓X|議事阻撓貓Y|異界阻撓貓	Filibuster Cat X|Filibuster Cat Y|Metafilibuster	필리버스터X|필리버스터Y|메타 필리버스터
終末兵器ムー|極秘研究機関パンドラ	終末兵器・異滅堂|秘研機關・潘朵殿	Mighty Kristul Muu|Doom Engine Pandora	종말 병기 무우|극비 연구기관 판도라
土偶戦士ドグ丸|土偶戦士ドグえもん|覚醒戦士ドグえもん	土偶喵丸|土偶叮噹|覺醒叮噹	Dogumaru|Doguemon|Reborn Warrior Doguemon	토우전사 도그마루|토우전사 도그에몽|각성전사 도그에몽
majimeow（仮）|majimeow（仮）進化	麻吉貓＆貓咪旅行團|麻吉貓＆貓咪遊寶島	|	|
ブラックゼウス|闇次神子ブラックゼウス	暗黑宙斯|闇次神子暗黑宙斯	Black Zeus|Dark Lord Zeus	블랙 제우스|암차신자 블랙 제우스
スーパーゼウス|全能神スーパーゼウス|スーパーSゼウス	超級宙斯|全能神超級宙斯|超級S宙斯	Super Zeus|All-Powerful Super Zeus|Super S-Zeus	슈퍼 제우스|전능신 슈퍼 제우스|슈퍼S 제우스
聖フェニックス|聖戦衣化聖フェニックス|ヘッドロココ	聖鳳凰|聖戰衣化聖鳳凰|首領洛可可	Holy Phoenix|Holy Warrior Phoenix|Head Rococo	세인트 피닉스|성전의화 세인트 피닉스|헤드 로코코
スーパーデビル|偽神スーパーデビル|スーパーDデビル	超級惡魔|偽神超級惡魔|超級D惡魔	Super Devil|Imposter Super Devil|Super D-Devil	슈퍼 데빌|위신 슈퍼 데빌|슈퍼D 데빌
サタンマリア|ワンダーマリア	撒旦瑪利亞|神奇瑪利亞	Satanmaria|Wondermaria	사탄마리아|원더마리아
ヘラクライスト|完璧ヘラクライスト|ブラックライスト	耶穌大力士|完美耶穌大力士|	Heracrist|Perfect Heracrist|	헤라클라이스트|퍼펙트 헤라클라이스트|
ネロ魔身|魔肖ネロ|デカネロン	猊玀魔身|魔肖猊玀|魔肖猊玀	Fiendish Nero|Beastly Nero|Beastly Nero	네로 마신|마초 네로|마초 네로
ヤマト王子|ヤマト神帝|ヤマト爆神	大和王子|大和王子神帝|大和王子爆神	Prince Yamato|Holy Yamato|Rampaging Yamato	야마토 왕자|야마토 신제|야마토 폭신
十字架天使|クロスエンジェル|ストライク天使	十字架天使|黃金十字架天使|劍球十字架天使	Rosary Angel|Cross Angel|Strike Angel	십자가천사|크로스엔젤|스트라이크 천사
ネコ若神子|ネコ神帝	貓咪若神子|貓咪神帝	Wakamiko Cat|Warrior King Cat	고양이 약신자|고양이 신제
ネコデビル|ネコ邪神	貓咪惡魔|貓咪邪神	Cat Devil|Infernal Cat	고양이 데빌|고양이 사신
ネコの助|ネコ老守	貓之助|貓老守	Nekonosuke|Old Guardian Cat	고양이노스케|고양이노수
幻の精霊ルミナ|夢幻の精霊ルミナリア	奇幻精靈露米納|夢幻精靈露米納里亞	Lumina|Luminalia	환상의 정령 루미나|몽환의 정령 루미나리아
グミネコ|ラッキーネコ|グミネコソーダ	||	||	||
ねこ娘|ネコねこ娘	|	|	|
超越科学者ヘヴン博士|時空科学者アビス博士	超越科學者天域博士|時空科學者深淵博士	Doktor Heaven|Professor Abyss	천재 과학자 헤븐 박사|시공 과학자 아비스 박사
幸せを願った少年ソウマ|幸せを願った少年ソウマ＆ネコ|幸せを願ったネコ耳ソウマ	祈求幸福的少年蒼真|祈求幸福的少年蒼真＆貓咪|祈求幸福的貓耳蒼真	Benevolent Souma|Souma ＆ Cat|Cat-Eared Souma	행복을 바란 소년 소우마|행복을 바란 소년 소우마&고양이|행복을 바란 고양이귀 소우마
カノとソウマ|カノとソウマとネコ	佳乃與蒼真|佳乃與蒼真與貓咪	Kano ＆ Souma|Kano ＆ Souma ＆ Cat	카노와 소우마|카노와 소우마와 고양이
黒ちびネコヴァルキリー|黒ちびネコヴァルキリー・紅	酷黑小小瓦爾基麗貓|酷黑寶島瓦爾姬娘	Li'l Valkyrie Dark|Dark Rider Valkyrie	다크 꼬마 고양이 발키리|다크 소녀 고양이 발키리
カレット|カレットCC	卡蕾特|卡蕾特CC	Calette|Calette CC	카렛트|카렛트CC
ひな|剣士ひな	姬娜|劍士姬娜	Hina|Swordswoman Hina	히나|검사 히나
エヴァ８号機|エヴァ８号機＆ネコ	EVA8號機|EVA8號機&貓咪	Eva Unit-08|Eva Unit-08 & Cat	에바 8호기|에바 8호기 & 고양이
空中艦艇ネコヴンダー|希望の船NNNネコヴンダー|神殺しの船NNNネコヴンダー	空中戰艦貓咪Wunder|希望之船喵喵Wunder|弒神之船喵喵Wunder	AAA Wunder|NNN Wunder|Vanished NNN Wunder	공중 전함 고양이 분더|희망의 선함  NNN 고양이 분더|살신의 선함 NNN 고양이 분더
ちびミサト|ヴンダー艦長のちびミサト	小小美里|Wunder艦長小小美里	Misato Katsuragi|Captain Misato	꼬맹이 미사토|분더 함장 꼬맹이 미사토
ちびリツコ|ヴンダー副長のちびリツコ	小小律子|Wunder副長小小律子	Ritsuko Akagi|First Officer Ritsuko	꼬맹이 리츠코|분더 부함장 꼬맹이 리츠코
ちびアヤナミレイ(仮称)|目覚めのちびアヤナミ	小小綾波零（暫稱）|覺醒的小小綾波零	Rei Ayanami (???)|Awakened Ayanami	꼬맹이 아야나미 레이 (가명)|잠에서 깨어난 꼬맹이 아야나미
493_1|493_2|493_3	HAPPI|HAPPI&麻吉貓|HAPPI&麻吉貓&貓咪	||	||
創造神ガイア|ゴッドガイア	大地女神蓋婭|至高無上女神蓋婭	Gaia the Creator|Gaia the Supreme 	창조신 가이야|창세주 가이야
潮風のセーラーカッパー|潮風のセーラーカッパーκ	潮風水手悟淨貓|潮風水手悟淨貓κ	Seabreeze Coppermine|Seabreeze Coppermine, type κ	바닷바람의 세일러 갓파|바닷바람의 세일러 갓파κ
ネコマタドール|ネコフラメンコ|ネコエキゾチック	鬥牛士貓|佛朗明哥舞貓|異國風情貓	Matador Cat|Flamenco Cat|Bellydance Cat	고양이 마타도르|고양이 플라멩코|고양이 벨리댄스
成田甲斐|武神・成田甲斐|豪炎姫の武神・成田甲斐	成田甲斐|武神・成田甲斐|豪炎姬武神・成田甲斐	Narita Kaihime|Wargod Kaihime|Immortal Kaihime	미네르바|분노의 미네르바|호염의 미네르바
498_1|498_2	戽斗貓|戽斗健美貓	Shakurel Cat|Shakurel Macho Cat	주걱턱 고양이|주걱턱 고양이 빌더
499_1|499_2	戽斗獅子|戽斗獅子CC	Shakurel Lion|Shakurel Lion CC	주걱턱 라이온|주걱턱 라이온CC
500_1|500_2	戽斗老虎|戽斗老虎CC	Shakurel Tiger|Shakurel Tiger CC	주걱턱 호랑이|주걱턱 호랑이CC
501_1|501_2	戽斗熊貓|戽斗熊貓CC	Shakurel Panda|Shakurel Panda CC	주걱턱 팬더|주걱턱 팬더CC
ネコ兄弟S|ネコバカ兄弟S	貓咪兄弟S|貓咪笨呆兄弟S	Cat Bros|Baka Cat Bros	고양이 형제S|고양이 바보 형제S
英雄令嬢メルシュ|英雄令嬢メルシュξ|絢爛令嬢メルシュξ	英雄令媛蜜斯|英雄令媛蜜斯ξ|絢爛令媛蜜斯ξ	Myrcia |Myrcia, type ξ|Divine Myrcia	멜슈|멜슈ξ|럭셔리 멜슈ξ
ネコ２Ｄ|ネコ３Ｄ	|	|	|
おやじネコ(店主)|おやじネコ(現役)	貓大叔【店主】|貓大叔【現役】	|	|
角龍グラディオス|角龍王グラディオス|角龍皇帝グラディオス	角龍格拉迪歐斯|角龍王格拉迪歐斯|角龍皇帝格拉迪歐斯	Relentless Gladios|Gladios the Annihilator|God-Emperor Gladios	각룡 그라디오스|각룡왕 그라디오스|각룡황제 그라디오스
アイウォルツ|アイウォルツCC|無名のアイウォルツCC	艾沃茲|艾沃茲CC|無名的艾沃茲CC	Eyewaltz|Eyewaltz CC|Nameless Eyewaltz CC	아이월츠|아이월츠CC|무명의 아이월츠CC
スーパーにゃん|ジャイにゃん	超人貓|硬漢超人貓	Mightycat|Supercat	슈퍼 고양이|메가 고양이
ネコリュウ|ネコリュウCC	隆貓|隆貓CC	Ryu Cat|Ryu Cat CC	고양이 류|고양이 류CC
ネコ春麗|ネコ春麗CC	春麗貓|春麗貓CC	Chun-Li Cat|Chun-Li Cat CC	고양이 춘리|고양이 춘리CC
豪鬼|豪鬼CC	豪鬼|豪鬼CC	Akuma|Akuma CC	고우키|고우키CC
リュウ|リュウCC|影ナル者	隆|隆CC|暗影之人	Ryu|Ryu CC|Kage	류|류CC|카게나루모노
春麗|春麗CC	春麗|春麗CC	Chun-Li|Chun-Li CC	춘리|춘리CC
ガイル|ガイルCC	蓋爾|蓋爾CC	Guile|Guile CC	가일|가일CC
ザンギエフ|ザンギエフCC	桑吉爾夫|桑吉爾夫CC	Zangief|Zangief CC	장기에프|장기에프CC
ブランカ|ブランカCC	布蘭卡|布蘭卡CC	Blanka|Blanka CC	블랑카|블랑카CC
ダルシム|ダルシムCC	塔爾錫|塔爾錫CC	Dhalsim|Dhalsim CC	달심|달심CC
ケン|ケンCC	肯|肯CC	Ken|Ken CC	켄|켄CC
ゴウキリン|ゴウキライオン	豪鬼長頸鹿|豪鬼獅子	Akuma Giraffe|Akuma Lion	고우키 기린|고우키 라이온
ラスヴォース|ファイナルラスヴォース|シン・ラスヴォース	拉斯沃斯|終極拉斯沃斯|真・拉斯沃斯	Lasvoss|Ultimate Lasvoss|Lasvoss Reborn	라스트 보스|파이널 라스트 보스|신 라스트 보스
ネコ七福神|ネコ七福邪神	貓咪七福神|貓咪七福邪神	Good-Luck Ebisu|Bad-Luck Ebisu	고양이 칠복신|고양이 칠복사신
ネコメデューサ|ネコツインテール|ネコナーガ	蛇髮貓杜莎|雙頭蛇髮貓杜莎|重量級蛇髮貓杜莎	Medusa Cat|Twintail Medusa Cat|Naga Cat	고양이 메두사|고양이 양갈래|고양이 나가
泉のネコ女神|ネコメダリスト|ネコ魔神	湖中女神貓|奪牌貓|貓咪魔神	Nymph Cat|Medalist Cat|Fiend Cat	고양이 금도끼은도끼|고양이 메달리스트|고양이 마신
ネコ武闘家|ネコ師範|ネコマスター	貓咪格鬥家|貓咪師傅|貓咪大師	Wushu Cat|Sifu Cat|Shigong Cat	고양이 무도가|고양이 사범|고양이 마스터
ソラカラちゃん|ソラカラちゃん＆ネコ	|	|	|
きんたろう|猛銃戦隊キンレンジャー|超銃戦隊キンレンジャー	金太郎|猛槍戰隊金呷勇|超槍戰隊金呷勇	Kintaro|Kinrangers RoboForce|Kinrangers GigaForce	긴타로|맹총전대 긴레인저|초총전대 긴레인저
冬天使のシシル＆コマリ|冬天使のシシル＆コマリΦ	冬天使西兒＆小毬|冬天使西兒＆小毬Φ	Snow Angel Twinstars|Snow Angel Twinstars, type Φ	겨울 천사 시시루와 코마리|겨울 천사 시시루와 코마리Φ
ネコスライム|ネコゼリーフィッシュ|ネコゼリーまんじゅう	史萊姆貓|水母貓|涼圓貓	Slime Cat|Jellycat|Jelly Dumpling Cat	고양이 슬라임|고양이 젤리피쉬|고양이 젤리만쥬
ネコサック|ネコウォッカ|ネコ近衛兵	哥薩克貓|伏特加貓|皇家衛兵貓	Cossack Cat|Vodka Cat|Royal Guard Cat	고양이 코사크|고양이 보드카|고양이 근위병
厄災の子キャスリィ|祝祭の聖女キャスリィ	災難少女凱斯莉|祝祭聖女凱斯莉	Kasli the Scourge|Ritual Saint Kasli	재앙의 캐슬리|축제의 성녀 캐슬리
エルメ|エルメCC	艾露梅|艾露梅CC	Herme|Herme CC	에르메|에르메CC
ネコックマ|ネコブラックマ|ネコックマンケン	熊熊貓咪|黑熊貓咪|怪人熊熊貓咪	Teacher BearCat|Assassin BearCat|Cadaver BearCat	네코쿠마|네코 블랙쿠마|네코 프랑켄슈타인 베어
フェンリルとウルス|ミケとウルス|覚醒のミケとウルス	巨狼與烏爾斯|米凱與烏爾斯|覺醒的米凱與烏爾斯	Urs & Fenrir|Urs & Minka|Awakened Urs	펜리르와 우르스|미케와 우르스|각성한 미케와 우르스
マッドシューター・サキ|ナイトバスター・サキ|バッドブラスター・サキ	狙擊天才沙紀|夜殺天才沙紀|爆破天才沙紀	Sharpshooter Saki|Nighthunter Saki|Bad Blaster Saki	매드슈터 사키|나이트버스터 사키|배드 블래스터 사키
冥界神ハデス|デスハーデス|Gデスハーデス	冥界神黑帝斯|冥界之王黑帝斯|G冥界之王黑帝斯	Hades the Punisher|Hades the Deathdealer|Almighty Hades	명계신 하데스|데스 하데스|G데스 하데스
初音ミク|初音ミクCC	初音未來|初音未來CC	Hatsune Miku|Hatsune Miku CC	하츠네 미쿠|하츠네 미쿠CC
桜ミク|桜ミクCC	櫻花未來|櫻花未來CC	Sakura Miku|Sakura Miku CC	사쿠라 미쿠|사쿠라 미쿠CC
鏡音リン＆レン|鏡音リン＆レンCC	鏡音鈴&連|鏡音鈴&連CC	Kagamine Rin & Len|Kagamine Rin & Len CC	카가미네 린&렌|카가미네 린&렌CC
ネコミク|ネコミクCC	貓初音|貓初音CC	Miku Cat|Miku Cat CC	고양이 미쿠|고양이 미쿠CC
ラガーにゃん|ニャメフト|ニャッハー	英式橄欖球貓|美式足球貓|戰鬥足球貓	Rugby Cat|Quarterback Cat|Gridiron Cat	럭비 고양이|미식축구 고양이|세기말 고양이
ネコU.F.O.|ネコ焼そばU.F.O.	|	|	|
ネコヤキソバン|うまい!太い!大きい!ネコ	|	|	|
ネコ少年|ネコ学生	|	|	|
禍根の魔女キャスリィ|漆黒の魔女ダークキャスリィ	禍根魔女凱斯莉|漆黑魔女凱斯莉	Kasli the Bane|Kasli, Daughter of Chaos	화근의 마녀 캐슬리|칠흑의 마녀 다크 캐슬리
京坂七穂|京坂七穂・真	京坂七穗|京坂七穗・真	Kyosaka Nanaho|True Kyosaka Nanaho	나나호|신검의 나나호
ネコファントム|ケムリネコ|ネコバブル	幻影貓|煙影貓|泡泡貓	Phantom Cat|Miasma Cat|Bubble Cat	팬텀 고양이|연기 고양이|고양이 버블
オイルガ|オイランパサラン|スケランカクラン	角擊貓|棒打白骨貓|令牌棒打白骨貓	Papaluga|Papalan Pasalan|Sukelan Kakulan	오이루가|오이란파사란|스케란카쿠란
白夜姫のレイ|白天姫のレイ	白夜姬零|白天姬零	Night Oracle Rei|Heavenly Herald Rei	백야 공주 레이|백천 공주 레이
第４の使徒|第４のネコ使徒	第4使徒|第4貓使徒	The 4th Angel|4th Angel Cat	제4사도|제4사도 고양이
第６の使徒|第６のネコ使徒	第6使徒|第6貓使徒	The 6th Angel|6th Angel Cat	제6사도|제6사도 고양이
第１０の使徒|第１０のネコ使徒	第10使徒|第10貓使徒	The 10th Angel|10th Angel Cat	제10사도|제10사도 고양이
第９の使徒|第９のネコ使徒	第9使徒|第9貓使徒	The 9th Angel|9th Angel Cat	제9사도|제9사도 고양이
ネコカヲル|月面のネコカヲル	薰貓|月面薰貓	Kaworu Cat|Moon Kaworu Cat	고양이 카오루|월면의 고양이 카오루
ネコベーカリー|ネコブーメラン|ネコフライングチキン	麵包師傅貓|迴力鏢貓|炸雞爺爺貓	Bakery Cat|Boomerang Cat|Fried Chicken Cat	고양이 베이커리|고양이 부메랑|고양이 플라잉 치킨
達人ウリル|ネコ仮面のウリル|ネコ神面のウリル	達人烏嚕哩|貓咪假面烏嚕哩|貓咪神面烏嚕哩	Master Uril|Mystic Uril|Esoteric Uril	달인 우리르|고양이 가면 우리르|고양이 가면신 우리르
シャーマンカーン|全情神シャーマンカーン	巫師汗|全情神巫師汗	Shaman Khan|All-Loving Shaman Khan	샤먼 칸|전정신 샤먼 칸
騎神アリババ|アリババ神帝|ゴーストアリババ	騎神阿里巴巴|阿里巴巴神帝|幽靈阿里巴巴	Holy Knight Alibaba|Holy King Alibaba|Ghost Alibaba	기신 알리바바|알리바바 신제|고스트 알리바바
天子男ジャック|神帝男ジャック	天子男傑克|神帝男傑克	Heavenly Jack|Heavenly Lord Jack	천자남 잭|신제남 잭
レアガチャネコ|福引ガチャネコ	稀有轉蛋貓|招福轉蛋貓	Gacha Cat|Lucky Gacha Cat	레어 뽑기 고양이|럭키 뽑기 고양이
地獄警官エマ|地獄軍曹エマ|閻魔総長エマ	地獄警官艾瑪|地獄軍曹艾瑪|閻魔總長艾瑪	Hell Warden Emma|Hell Sentinel Emma|Hell Commissioner Emma	지옥 경찰 엠마|지옥 중사 엠마|염라 대장 엠마 
巡音ルカ|巡音ルカCC	巡音流歌|巡音流歌CC	Megurine Luka|Megurine Luka CC	메구리네 루카|메구리네 루카CC
MEIKO＆ネコ|MEIKO＆ネコCC	MEIKO＆貓咪|MEIKO＆貓咪CC	MEIKO & Cat|MEIKO & Cat CC	MEIKO＆고양이|MEIKO＆고양이CC
ネコルカ|ネコルカCC	貓咪流歌|貓咪流歌CC	Luka Cat|Luka Cat CC	고양이 루카|고양이 루카CC
アクアシューター・サキ|アクアバスター・サキ|アクアブラスター・サキ	海漾狙擊天才沙紀|夜海惡殺天才沙紀|護海戰士天才沙紀	Squirtgun Saki|Aquabuster Saki|Aquablaster Saki	아쿠아슈터 사키|아쿠아버스터 사키|아쿠아 블래스터 사키
ネコルガの夏|ミワクノパサラン|ファビュラスパサラン	仲夏不明貓|魅惑不明貓|名媛不明貓	Summerluga |Bikinilan Pasalan|Fabulous Pasalan	고양이 루가의 여름|매혹의 파사란|엘레강스 파사란
日焼けネコ|日焼けネコビルダー|日焼けネコパーマ	日曬貓|日曬健美貓|日曬爆炸頭貓	Suntan Cat|Macho Suntan Cat|Permed Suntan Cat 	선탠 고양이|선탠 고양이 빌더|선탠 고양이 파마
救命にゃんこ|ダンゴにゃん兄弟|ネコジェラート	救生貓兄弟|糰子貓兄弟|冰淇淋貓兄弟	Lifeguard Cats|Sweet Bro Cats|Gelato Bro Cats	라이프가드 고양이|당고 고양이 형제|고양이 젤라또
チビクロプスネコタマゴ|チビクロプスネコ|雷電のチビクロプスネコ	||	||	||
イディ:N|イディ:N2|イディ:NX	異弟:N|異弟:N2|異弟:NX	Idi:N|Idi:N2|Idi:NX	이디:N|이디:N2|이디:NX
石の精霊ゴロー|岩石の精霊イワゴロー|岩石の精霊王ダイゴロー	石精靈滾瓦|岩石精靈伊瓦|岩石精靈王強韌伊瓦	Gravi|Gravolo|Gravolodon	돌의 정령 롤링스톤|암석의 정령 락앤롤|암석의 정령왕 스톤헨지
竜騎士スカルバルス|ナイトメアバルス|ハロウィンナイトバルス	龍騎士斯卡巴魯斯|暗夜梅亞巴魯斯|萬聖節騎士巴魯斯	Skull Rider Vars|Nightmare King Vars|Halloween Knight Vars	용기사 스컬 바르스|나이트메어 바르스|할로윈 나이트 바르스
エドモンド本田|エドモンド本田CC	E. HONDA|E. HONDA CC	E. Honda|E. Honda CC	E. Honda|E. Honda CC
バイソン|バイソンCC	拜森|拜森CC	Balrog|Balrog CC	바이슨|바이슨CC
バルログ|バルログCC	巴洛克|巴洛克CC	Vega|Vega CC	발로그|발로그CC
サガット|サガットCC	沙卡特|沙卡特CC	Sagat|Sagat CC	사가트|사가트CC
ベガ|ベガCC	貝卡|貝卡CC	M. Bison|M. Bison CC	베가|베가CC
ネコモンド本田|ネコモンド本田CC	C. HONDA|C. HONDA CC	C. Honda|C. Honda CC	C. Honda|C. Honda CC
ネコバイソン|ネコバイソンCC	拜森貓|拜森貓CC	Balrog Cat|Balrog Cat CC	고양이 바이슨|고양이 바이슨CC
ネコバルログ|ネコバルログCC	巴洛克貓|巴洛克貓CC	Vega Cat|Vega Cat CC	고양이 발로그|고양이 발로그CC
ネコサガット|ネコサガットCC	沙卡特貓|沙卡特貓CC	Sagat Cat|Sagat Cat CC	고양이 사가트|고양이 사가트CC
ネコベガ|ネコベガCC	貝卡貓|貝卡貓CC	M. Bison Cat|M. Bison Cat CC	고양이 베가|고양이 베가CC
ごろにゃん|ごろにゃーん	岩貓|礦貓	Stone Cat|Boulder Cat	스톤 고양이|볼더 고양이
初音ミク マジカルミライ2020大阪|初音ミクCC マジカルミライ2020大阪	初音未來 MAGICAL MIRAI 2020大阪|初音未來CC MAGICAL MIRAI 2020大阪	Hatsune Miku: MM2020 Osaka|Hatsune Miku CC: MM2020 Osaka	하츠네 미쿠 MAGICAL MIRAI 2020 오사카|하츠네 미쿠CC MAGICAL MIRAI 2020 오사카
初音ミク マジカルミライ2020東京|初音ミクCC マジカルミライ2020東京	初音未來 MAGICAL MIRAI 2020東京|初音未來CC MAGICAL MIRAI 2020東京	Hatsune Miku: MM2020 Tokyo|Hatsune Miku CC: MM2020 Tokyo	하츠네 미쿠 MAGICAL MIRAI 2020 도쿄|하츠네 미쿠CC MAGICAL MIRAI 2020 도쿄
前田サンタ慶次|前田クリス慶次|前田クリス慶次DX	聖誕慶次|聖誕樹慶次|聖誕樹慶次DX	Keiji Claus|Maeda Christmas|Maeda Christmas DX	산타 백호|크리스마스 백호|크리스마스 백호 DX
幼獣ガル|帝獣ガルディアン	幼獸加爾|帝獸加迪	Baby Garu|Mighty Aegis Garu	요수 가루|제수 가르디언
ネコ王子|ネコ国王	貓咪王子|貓咪國王	Emperor Cat|Tyrant Cat	고양이 왕자|고양이 국왕
恋女神ショコラディーテ|メガショコラディーテ	戀女神可可黛蒂|華麗黃金可可黛蒂	Sweet Aphrodite|Chocoladite	사랑의 여신 쇼콜라디테|메가쇼콜라디테
初恋令嬢メルシュ|初恋令嬢メルシュξ	初戀令媛蜜斯|初戀令媛蜜斯ξ	First-Love Myrcia|First-Love Myrcia ξ	첫사랑 멜슈|첫사랑 멜슈ξ
バレンタインねねこ|バレンタインチョコねねこ|本命・バレンタインねねこ	情人節萌萌貓|情人節巧克力萌萌貓|真愛情人節萌萌貓	Valentine's Neneko|Sweetheart Neneko|True Love Neneko	발렌타인 귀요미|발렌타인 초코 귀요미|진심・발렌타인 귀요미
雪ミク 2021|雪ミクCC 2021	雪未來 2021|雪未來CC 2021	Snow Miku 2021|Snow Miku CC 2021	유키 미쿠 2021|유키 미쿠CC 2021
KAITO＆ネコ|KAITO＆ネコCC	KAITO＆貓咪|KAITO＆貓咪CC	KAITO & Cat|KAITO & Cat CC	KAITO＆고양이|KAITO＆고양이CC
ネコリン|ネコリンCC	貓咪鈴|貓咪鈴CC	Neko Rin|Neko Rin CC	고양이 린|고양이 린CC
ネコレン|ネコレンCC	貓咪連|貓咪連CC	Neko Len|Neko Len CC	고양이 렌|고양이 렌CC
空中商会コロンブス|輸送兵団アトランチス|超輸送兵団アトランチス	空中商店・探險家|運送兵團・文明組|超運送兵團・文明組	Mighty Aethur Ltd.|Atlantis Logistix|Ultra Atlantis Logistix	공중상사 콜럼버스|수송병단 아틀란티스|초수송병단 아틀란티스
春龍かむくら|神春龍かむくら|神春龍王かむくら	春龍卡姆庫拉|神春龍卡姆庫拉|神春龍王卡姆庫拉	Blooming Kamukura|Everbloom Kamukura|Everbloom Lord Kamukura	춘룡 카무쿠라|신춘룡 카무쿠라|신춘룡왕 카무쿠라
早乙女乱馬(男)|早乙女らんま(女)	早乙女亂馬(男)|早乙女亂馬(女)	Ranma Saotome (M)|Ranma Saotome (F)	사오토메 란마(남)|사오토메 란마(여)
天道あかね|天道あかね(道着)	天道茜|天道茜(道服)	Akane Tendo|Akane Tendo (Gi)	텐도 아카네|텐도 아카네(도복)
響良牙(ブタ)|響良牙	響良牙(黑豬)|響良牙	Ryoga Hibiki (Pig)|Ryoga Hibiki	히비키 료가(돼지)|히비키 료가
シャンプー(猫)|シャンプー	珊璞(貓)|珊璞	Shampoo (Cat)|Shampoo	샴푸(고양이)|샴푸
ムース(アヒル)|ムース	沐絲(鴨)|沐絲	Mousse (Duck)|Mousse	무스(오리)|무스
八宝斉|八宝斉(エロじじい)	八寶齋|八寶齋(色鬼)	Happosai|Happosai (Lewd)	핫포사이|핫포사이(변태 할아범)
久遠寺右京(男装)|久遠寺右京	久遠寺右京(男裝)|久遠寺右京	Ukyo Kuonji (GR)|Ukyo Kuonji	쿠온지 우쿄(남장)|쿠온지 우쿄
九能帯刀(道着)|九能帯刀	九能帶刀(道服)|九能帶刀	Tatewaki Kuno (Gi)|Tatewaki Kuno	쿠노 타테와키(도복)|쿠노 타테와키
ネコ乱馬(男)|ネコらんま(女)	貓亂馬(男)|貓亂馬(女)	Ranma Cat (M)|Ranma Cat (F)	고양이 란마(남)|고양이 란마(여)
ネコあかね|ネコあかね(道着)	貓小茜|貓小茜(道服)	Akane Cat|Akane Cat (Gi)	고양이 아카네|고양이 아카네(도복)
ネコパンダ|ネコ玄馬	貓熊貓|貓玄馬	Panda Cat|Genma Cat	고양이 판다|고양이 겐마
冒険家カンナ|大冒険少女カンナ|伝説の冒険少女カンナ	冒險家佳奈|大冒險少女佳奈|傳說的冒險少女佳奈	Adventurer Kanna|Swashbuckler Kanna|Fabled Adventure Girl Kanna	모험가 칸나|대모험 소녀 칸나|전설의 모험 소녀 칸나
ネコウエハース|ネコウエハースBIG	|	|	|
黒獣ガルディアン|帝獣ダークガルディアン	黑獸加迪|帝獸黑暗加迪	Dark Aegis Garu|Dark Beastlord Garu	흑수 가르디언|제수 다크 가르디언
金塊ネコ|キングネコインゴット|キングネコカーメン	金塊貓|金條貓|黃金法老貓	Gold Brick Cat|King Ingot Cat|King Nekokhamen	골드바 고양이|골드 킹 고양이|가면 킹 고양이
ネコゴジラ|シン・ネコゴジラ	哥吉拉貓|正宗哥吉拉貓	Godzilla Cat|Shin Godzilla Cat	고양이 고질라|신 고양이 고질라
ネコ王女|ネコ女王	貓咪王女|貓咪女王	Princess Cat|Empress Cat	고양이 왕녀|고양이 여왕
古神面ドロン|ネコ神面ドロン|覚醒ネコ神面ドロン	古神面多龍|貓神面多龍|覺醒貓神面多龍	Elder Mask Doron|Cat Mask Doron|Awakened Doron	고대 가면신 드론|고양이 가면신 드론|각성한 고양이 가면신 드론
渚のかぐやひめ|南国衛星サンシャイン|南国衛星スーパーシャイン	陸海輝夜姬|南國衛星・陽光兵器|南國衛星・超級烈日兵器	Kaguya of the Coast|The Southern Sun|The Southern Sunflare	바닷가의 대나무 공주|남국위성 선 샤인|남국위성 슈퍼 샤인
カブトネコ|ゴールデンオオカブトネコ	獨角貓|黃金獨角貓	Kabuto Cat|Golden Kabuto Cat	장수풍뎅이 고양이|골드 장수풍뎅이 고양이
クワガタネコ|キングクワガタネコ	鍬形貓|王者鍬形貓	Kuwagata Cat|King Kuwagata Cat	사슴벌레 고양이|킹 사슴벌레 고양이
召喚少年サトル|悪魔召喚サトル|デビルハンターサトル	召喚少年小悟|惡魔召喚小悟|惡魔獵人小悟	Summoner Satoru|Dark Summoner Satoru|Devil Hunter Satoru	소환소년 사토루|악마 소환소년 사토루|데빌 헌터 사토루
天草四郎|魔神・天草四郎|怨嗟の魔神・天草四郎	天草四郎|魔神・天草四郎|怨恨魔神・天草四郎	Shiro Amakusa|Wargod Amakusa|Immortal Amakusa	아레스|마신 아레스|원망의 마신 아레스
妖賢女リリン|妖賢女リリンπ|大賢女リリンπ	妖賢女莉莉|妖賢女莉莉π|大賢女莉莉π	Lilin|Lilin π|Divine Lilin π	리린|리린π|와이즈 리린π
邪龍ヘヴィジャーク|邪龍王ヘヴィジャーク|邪龍皇帝ヘヴィジャーク	邪龍赫維賈克|邪龍王赫維賈克|邪龍皇帝赫維賈克	Hevijak the Wicked|Wicked King Hevijak|God-Emperor Hevijak	사룡 헤비저크|사룡왕 헤비저크|사룡황제 헤비저크
悪魔研究家|邪悪な悪魔研究家|にゃんこ研究家	惡魔研究家|邪惡的惡魔研究家|貓咪研究家	Aku Researcher|Evil Aku Researcher|Cat Researcher	악마연구가|사악한 악마연구가|냥코 연구가
ジャガンドーJr|破壊神ジャガンドーJr	邪根德Jr|破壞神邪根德Jr	Jagando Jr.|Lord of Ruin Jagando Jr.	자간드 Jr|파괴신 자간드 Jr
ネコハーメルン|虚無僧ネコ	魔笛貓|虛無僧貓	Pied Piper Cat|Komuso Cat	고양이 하멜론|무소유 승려 고양이
熱血硬派くにおくん|ドッジボール部くにおくん	熱血硬派國夫君|躲避球社國夫君	Kunio-kun|Dodgeball Kunio-kun	열혈경파 쿠니오군|피구부 쿠니오군
オコルガ|オコランパサラン|ゲキオコパサラン	怒髮貓|髮鞭白骨貓|暴怒髮鞭白骨貓	Furiluga|Furilan Pasalan|Ragelan Pasalan	오코루가|오코란파사란|극대노 파사란
ネコキリンモドキ|駿馬ネコキリンモドキ	|	|	|
ネコノトリッキー|天馬ネコノトリッキー	|	|	|
ネコノドラゴーン|名馬ネコノドラゴーン	|	|	|
洗脳されしネコ|洗脳されしネコビルダー|洗脳されしネコモヒカン	遭洗腦的貓咪|遭洗腦的健美貓|遭洗腦的摩西根貓	Brainwashed Cat|Brainwashed Macho Cat|Brainwashed Mohawk Cat	세뇌된 고양이|세뇌된 고양이 빌더|세뇌된 고양이 모히칸
ネコ書道|ネコ茶道	書道貓|茶道貓	Calligraphy Cat|Tea Master Cat	고양이 서예|고양이 다도 
闇の精霊ヤミィ|暗黒の精霊ヤミノワール|暗黒の精霊王ヤミノワールド	闇精靈亞米|暗黑精靈亞米諾瓦|暗黑精靈王亞米諾瓦多	Yamii|Yaminoir|Yaminora	어둠의 정령 야미|암흑의 정령 야미누아르|암흑의 정령왕 야미슈발츠
超竜戦機デス・トロイ|電磁戦機ディア・ボロス|超電磁戦機ディア・ボロス	超龍戰機・毀滅團|電磁戰機・殲滅團|超電磁戰機・殲滅團	Mighty Deth-Troy-R|Siege Walker Diabolosa|Obliterator Diabolosa	초용전기 데스 트로이|전자전기 디아 볼로스|초전자전기 디아 볼로스
舌切りすずめ|妖怪結社チュンチュン|大妖怪結社チュンチュン	舌切雀|妖怪結社沖沖衝|大妖怪結社沖沖衝	Shitakiri Sparrow|Chunchun Haunters|Grand Chunchun Haunters	혀 잘린 참새|요괴 결사 짹짹|대요괴 결사 짹짹
白騎士キュクロプス|黒騎士キュクロプス|神魔騎士キュクロプス	白騎士庫克洛普斯|黑騎士庫克洛普斯|神魔騎士庫克洛普斯	White Knight Cyclops|Black Knight Kyklops|Demon Knight Kyklops	백기사 키클롭스|흑기사 키클롭스|신마기사 키클롭스
100万ドルのネコ|1億ドルのネコ	一百萬的貓|一億元的貓	Million-Dollar Cat|Hundred-Million-Dollar Cat	100만불 고양이|1억불 고양이
洗脳されしタンクネコ|洗脳されしネコカベ|洗脳されしゴムネコ	遭洗腦的坦克貓|遭洗腦的牆貓|遭洗腦的橡皮貓	Brainwashed Tank Cat|Brainwashed Wall Cat|Brainwashed Eraser Cat	세뇌된 탱크 고양이|세뇌된 고양이 벽|세뇌된 고무 고양이
シャオチョン＆ネコ|シャオチョン＆ネコCC	小穹&貓咪|小穹&貓咪CC	|	|
ナナ＆ネコ|ナナ＆ネコCC	耐耐&貓咪|耐耐&貓咪CC	|	|
エミリア＆ネコ|エミリア&ネコCC	艾米莉亞&貓咪|艾米莉亞&貓咪CC	|	|
ジェアー＆ネコ|ジェアー＆ネコCC	婕兒&貓咪|婕兒&貓咪CC	|	|
踊り子イズ|魅惑の舞姫イズ	歡笑揮舞孃|魅惑舞姬孃	Iz the Dancer|Iz the Alluring Dancer	무희 이즈|매혹의 무희 이즈
堕天神ルシファー|グランドルシファー|Gグランドルシファー	墮天神路西法|崇高之神路西法|G崇高之神路西法	Lucifer the Fallen|Grand Lucifer|Almighty Lucifer	타락 천신 루시퍼|그랜드 루시퍼|G그랜드 루시퍼
ネコ超人|ネコ超人Ⅱ|真ネコ超人	貓咪超人|貓咪超人Ⅱ|真貓咪超人	Superfeline|Superfeline II|True Superfeline	고양이 초인|고양이 초인Ⅱ|레전드 고양이 초인
白い恋人メカ子|ビタースイートメカ子|LOVEミントメカ子	白色情人機器子|苦甜參半機器子|最愛薄荷機器子	Sweet Love Mekako|Bittersweet Mekako|Minty Love Mekako	하얀 연인 메카소녀 진|비터 스위트 메카소녀 진|민초단 메카소녀 진
洗脳されしバトルネコ|洗脳されし勇者ネコ|洗脳されし暗黒ネコ	遭洗腦的戰鬥貓|遭洗腦的勇者貓|遭洗腦的暗黑貓	Brainwashed Axe Cat|Brainwashed Brave Cat|Brainwashed Dark Cat	세뇌된 배틀 고양이|세뇌된 용사 고양이|세뇌된 암흑 고양이
爆竹ネコ|爆竹ネコビルダー	鞭炮貓|鞭炮健美貓	Firecracker Cat|Macho Firecracker Cat	폭죽 고양이|폭죽 고양이 빌더
狩猟娘テルン|狩猟娘テルンζ|大狩猟娘テルンζ	狩獵女孩媞倫|狩獵女孩媞倫ζ|大狩獵女孩媞倫ζ	Huntress Terun|Huntress Terun ζ|Divine Huntress Terun ζ	테룬|테룬ζ|헌트리스 테룬ζ
恋番長・鬼にゃんま|恋愛番長・鬼神にゃんま	愛情番長惡鬼喵魔|戀愛番長鬼神喵魔	Lovestruck Lesser Demon|Lovestruck Greater Demon	사랑대장 도깨비 야옹마|연애대장 도깨비신 야옹마
服部半蔵|忍神・服部半蔵|絶影の忍神・服部半蔵	服部半藏|忍神・服部半藏|絕影忍神・服部半藏	Hattori Hanzo|Wargod Hanzo|Immortal Hanzo	흑표|분노의 흑표|절영의 흑표
幼馴染にゃん子|彼女にゃん子	青梅竹馬喵美|女朋友喵美	Secret Crush Cat|Girlfriend Cat	소꿉친구 냥코|여자친구 냥코
おてんばネコライオン|鉄仮面ネコライオン	淘氣獅子貓|鐵假面獅子貓	Tomboy Lion Cat|Iron-Masked Lion Cat	말괄량이 고양이 라이온|철가면 고양이 라이온
ネコクバンケシ|ネコクバンチョウ	板擦貓|番長板擦貓	Chalkboard Eraser Cat|Chalkboard Punk Cat	고양이 칠판지우개|고양이 칠판대장
古獣ナーラ|雷古獣ナーラ|覚醒古獣ナーラ	古獸納拉|雷古獸納拉|覺醒古獸納拉	Elder Beast Naala|Storm Beast Naala|Awakened Naala	고대수 나라|벼락의 고대수 나라|각성 고대수 나라
洗脳されしキモネコ|洗脳されし美脚ネコ|洗脳されしムキあしネコ	遭洗腦的噁心貓|遭洗腦的美腿貓|遭洗腦的筋肉美腿貓	Brainwashed Gross Cat|Brainwashed Sexy Legs Cat|Brainwashed Macho Legs Cat	세뇌된 징글 고양이|세뇌된 각선미 고양이|세뇌된 불끈다리 고양이
氷の精霊フリズ|氷結の精霊ブリザーナ|氷結の精霊王ブリザレーナ	冰精靈布莉茲|冰結精靈布莉莎娜|冰結精靈王布莉莎雷娜	Bliza|Blizana|Blizarena	얼음의 정령 블리즈|빙결의 정령 블리자나|빙결의 정령왕 블리자레나
古びたタマゴ:N001|謎のタマゴ:N001|ネコはにわ	遠古的蛋：N001|謎樣的蛋：N001|埴輪貓	Ancient Egg: N001|Mystic Egg: N001|Haniwa Cat	오래된 알: N001|신비한 알: N001|고양이 토용
悲嘆の踊り子イズ|哀悼の舞姫ダークイズ	悲嘆揮舞孃|哀悼黑暗舞姬孃	Iz the Dancer of Grief|Iz the Lady of Mourning	비탄의 무희 이즈|애도의 무희 다크 이즈
古びたタマゴ:N101|赤いタマゴ:N101|飛脚ネコ	遠古的蛋：N101|紅色的蛋：N101|飛腳貓	Ancient Egg: N101|Cinnabar Egg: N101|Courier Cat	오래된 알: N101|붉은 알: N101|배달 고양이
古びたタマゴ:N102|青いタマゴ:N102|ネコターさん	遠古的蛋：N102|藍色的蛋：N102|泰山貓	Ancient Egg: N102|Teal Egg: N102|Catarzan	오래된 알: N102|푸른 알: N102|고양이 타장
海龍ダライアサン|海龍王ダライアサン|海龍皇帝ダライアサン	海龍達萊亞薩|海龍王達萊亞薩|海龍皇帝達萊亞薩	Sea Serpent Daliasan|Sea King Daliasan|God-Emperor Daliasan	해룡 다라이어던|해룡왕 다라이어던|해룡황제 다라이어던
祝福神クロノス|ウェディングクロノス	祝福神克羅諾絲|新娘克羅諾絲	Chronos the Bride|Wedding Chronos	축복의 신 크로노스|웨딩 크로노스
洗脳されしウシネコ|洗脳されしネコキリン|洗脳されしネコライオン	遭洗腦的牛貓|遭洗腦的長頸鹿貓|遭洗腦的獅子貓	Brainwashed Cow Cat|Brainwashed Giraffe Cat|Brainwashed Lion Cat	세뇌된 황소 고양이|세뇌된 기린 고양이|세뇌된 고양이 라이온
古びたタマゴ:N103|黒いタマゴ:N103|ネコガスマスク	遠古的蛋：N103|黑色的蛋：N103|防毒面具貓	Ancient Egg: N103|Black Egg: N103|Gas Mask Cat	오래된 알: N103|검은 알: N103|고양이 방독면
古びたタマゴ:N104|緑のタマゴ:N104|ネコオペ	遠古的蛋：N104|綠色的蛋：N104|手術貓	Ancient Egg: N104|Green Egg: N104|Surgeon Cat	오래된 알: N104|녹색 알: N104|수술 고양이
古びたタマゴ:N201|悪のタマゴ:N201|ネコソシスト	遠古的蛋：N201|邪惡的蛋：N201|驅魔貓	Ancient Egg: N201|Dark Egg: N201|Exorcist Cat	오래된 알: N201|악의 알: N201|냥소시스트
ナイトビーチリリン|ナイトビーチリリンπ	星光沙灘女莉莉|星光沙灘女莉莉π	Night Beach Lilin|Night Beach Lilinπ	여름밤 해변의 리린|여름밤 해변의 리린π
洗脳されしネコノトリ|洗脳されしネコUFO|洗脳されし天空のネコ	遭洗腦的鳥貓|遭洗腦的UFO貓|遭洗腦的天空之貓	Brainwashed Bird Cat|Brainwashed UFO Cat|Brainwashed Flying Cat	세뇌된 고양이 새|세뇌된 고양이UFO|세뇌된 천공의 고양이
ネコ天狗|大妖怪ネコ天狗|大神仙ネコ天狗	天狗貓|大妖怪天狗貓|大神仙天狗貓	Cat Tengu|Grand Yokai Tengu|Immortal Master Tengu	고양이 텐구|대요괴 고양이 텐구|대신선 고양이 텐구
古びたタマゴ:N003|悪のタマゴ:N003|ネコサボテン	遠古的蛋：N003|邪惡的蛋：N003|仙人掌貓	Ancient Egg: N003|Evil Egg: N003|Cat Cactus	오래된 알: N003|악의 알: N003|고양이 선인장
古びたタマゴ:N202|赤いタマゴ:N202|アーマードホタルネコ	遠古的蛋：N202|紅色的蛋：N202|鎧甲螢火貓	Ancient Egg: N202|Cinnabar Egg: N202|Armored Firefly Cat	오래된 알: N202|붉은 알: N202|아머드 반딧불이 고양이
早乙女らんま(レオタード)|早乙女らんま(チアガール)	早乙女亂馬(體操選手)|早乙女亂馬(啦啦隊)	Ranma Saotome (Leotard)|Ranma Saotome (Cheer)	사오토메 란마(레오타드)|사오토메 란마(치어리더)
早乙女玄馬(パンダ)|早乙女玄馬	早乙女玄馬(熊貓)|早乙女玄馬	Genma Saotome (Panda)|Genma Saotome	사오토메 겐마(판다)|사오토메 겐마
ネコチーター	ネコチーター	ネコチーター	ネコチーター
周遊芸団カルーセルズ|奇襲怪光エンヴァンズ|超奇襲怪光エンヴァンズ	周遊藝團・雜耍隊|奇襲怪光・幽浮隊|超奇襲怪光・幽浮隊	Mighty Carrowsell|Extraterrestrial Envanz|Extradimensional Envanz	유랑극단 캐러셀즈|기습괴광 유에포즈|초기습괴광 유에포즈
古びたタマゴ:N105|青いタマゴ:N105|ネコスマッシュ	遠古的蛋：N105|藍色的蛋：N105|網球貓	Ancient Egg: N105|Teal Egg: N105|Racquet Cat	오래된 알: N105|푸른 알: N105|고양이 스매시
古びたタマゴ:N106|黄色いタマゴ:N106|ネコキノコ	遠古的蛋：N106|黃色的蛋：N106|香菇貓	Ancient Egg: N106|Amber Egg: N106|Mushroom Cat	오래된 알: N106|노란 알: N106|고양이 버섯
三雲修＆ネコ|三雲修＆ネコCC	三雲修＆貓咪|三雲修＆貓咪CC	Osamu Mikumo & Cat|Osamu Mikumo & Cat CC	미쿠모 오사무&고양이|미쿠모 오사무&고양이CC
空閑遊真＆ネコ|空閑遊真＆ネコCC	空閑遊真＆貓咪|空閑遊真＆貓咪CC	Yuma Kuga & Cat|Yuma Kuga & Cat CC	쿠가 유마&고양이|쿠가 유마&고양이CC
雨取千佳＆ネコ|雨取千佳＆ネコCC	雨取千佳＆貓咪|雨取千佳＆貓咪CC	Chika Amatori & Cat|Chika Amatori & Cat CC	아마토리 치카&고양이|아마토리 치카&고양이CC
さくら|さくらCC	櫻|櫻CC	Sakura|Sakura CC	카스가노 사쿠라|카스가노 사쿠라 CC
ルーク|ルークCC	路克|路克CC	Luke|Luke CC	루크|루크CC
女神ベガ|幻影の加護女神ベガ|虚影の加護女神ベガ	闇女神蓓卡|幻影加持闇女神蓓卡|虛影加持闇女神蓓卡	Spectral Goth Vega|Illusory Guardian Vega|Lady of Deception Vega	여신 베가|환영의 가호여신 베가|허영의 가호여신 베가
伯爵・真田幸村|吸血鬼・真田幸村|吸血鬼公爵・真田幸村	伯爵・真田幸村|吸血鬼・真田幸村|吸血鬼公爵・真田幸村	Count Yukimura|Nosferatu Yukimura|Vampiric Yukimura	백작 그리폰|흡혈귀 그리폰|흡혈귀 공작 그리폰
洗脳されしネコフィッシュ|洗脳されしネコクジラ|洗脳されしネコ島	遭洗腦的魚貓|遭洗腦的鯨貓|遭洗腦的島貓	Brainwashed Fish Cat|Brainwashed Whale Cat|Brainwashed Island Cat	세뇌된 고양이 피쉬|세뇌된 고양이 고래|세뇌된 고양이 섬
古びたタマゴ:N004|謎のタマゴ:N004|ネコスーパーカー	遠古的蛋：N004|謎樣的蛋：N004|小鴨車車貓	Ancient Egg: N004|Mystic Egg: N004|Supercar Cat	오래된 알: N004|신비한 알: N004|고양이 슈퍼카
光の女神シリウス|来光の女神シリウス	光之女神希莉烏斯|晨光女神希莉烏斯	Goddess of Light Sirius|Goddess of Sunrise Sirius	빛의 여신 시리우스|광명의 여신 시리우스
トナカイ娘テルン|トナカイ娘テルンζ	馴鹿女孩媞倫|馴鹿女孩媞倫ζ	Reindeer Terun|Reindeer Terunζ	사슴뿔 테룬|사슴뿔 테룬ζ
洗脳されしネコトカゲ|洗脳されしネコドラゴン|洗脳されしネコキングドラゴン	遭洗腦的蜥蜴貓|遭洗腦的龍貓|遭洗腦的龍王貓	Brainwashed Lizard Cat|Brainwashed Dragon Cat|Brainwashed King Dragon Cat	세뇌된 고양이 도마뱀|세뇌된 고양이 드래곤|세뇌된 고양이 킹드래곤
石の上にも10年ネコ|石の上にも10年ネコ像	|	Meditation Cat|Paragon Cat	10년이면 고양이|10년이면 고양이 동상
運命の子フォノ|天命の王フォノウ	命運之子佛諾|天命之王佛挪	Child of Destiny Phono|King of Destiny Phonoa	운명의 아이 포노|천명의 왕 포노아
古びたタマゴ:N000|古のタマゴ:N000|猿人ネコルーザ	遠古的蛋：N000|古代的蛋：N000|猿人貓露薩	Ancient Egg: N000|Elder Egg: N000|Ape Lord Luza	오래된 알: N000|고대의 알: N000|에이프 고양이 루자
いっすん法師|鬼襲艇コヅチマル|鬼襲戦艇コヅチマル	一寸法師|鬼襲艇小槌號|鬼襲戰艇小槌號	Issun Boshi|Oni Landshaker Kozuchimaru|Oni Battlepod Kozuchimaru	엄지 동자|귀습잠수함 방망-E|귀습전투함 방망-E
白執事探偵ヴィグラー|黒執事探偵グラヴィー	白執事偵探吳仲力|黑執事偵探吳仲力	White Butler Vigler|Black Butler Vigler	백집사 탐정 비그라|흑집사 탐정 그라비
洗脳されし巨神ネコ|洗脳されしネコダラボッチ|洗脳されしネコジャラミ	遭洗腦的巨神貓|遭洗腦的巨人貓|遭洗腦的賈拉米貓	Brainwashed Titan Cat|Brainwashed Mythic Titan|Brainwashed Jamiera Cat	세뇌된 거신 고양이|세뇌된 고양이 다라보치|세뇌된 고양이 쟈라미
殺意のタンクネコ|真・殺意のタンクネコ	殺意坦克貓|真・殺意坦克貓	Killer Tank Cat|True Killer Tank Cat	살의의 탱크 고양이|독기의 탱크 고양이
ネコ委員長|裏ネコ委員長	班長貓|叛逆班長貓	Class Rep Cat|Stealth Class Rep Cat	고양이 반장|불량 고양이 반장
古びたタマゴ:N107|紫のタマゴ:N107|ネコ村長	遠古的蛋：N107|紫色的蛋：N107|村長貓	Ancient Egg: N107|Violet Egg: N107|Cat Chief	오래된 알: N107|보라색 알: N107|고양이 촌장
サンダージャック|ブラッディージャック	閃電傑克|黑雷傑克	Thunder Jack|Bloody Jack	썬더 잭|블러디 잭
決闘少年ラビットサトル|決闘王者ラビットサトル	決鬥少年兔裝小悟|決鬥王者兔裝小悟	Rabbit Satoru|Rabbit Champion Satoru	결투소년 래빗 사토루|결투왕 래빗 사토루
古びたタマゴ:N005|謎のタマゴ:N005|ネコヒットマン	遠古的蛋：N005|謎樣的蛋：N005|殺手貓	Ancient Egg: N005|Mystic Egg: N005|Hitman Cat	오래된 알: N005|신비한 알: N005|고양이 히트맨
にゃんこ仮面ライダー|シン・仮面ライダーにゃんこ	|	|	|
ゴジラにゃんこ|シン・ゴジラにゃんこ	|	|	|
エヴァンゲリオンにゃんこ|シン・エヴァンゲリオンにゃんこ	|	|	|
ウルトラマンにゃんこ|シン・ウルトラマンにゃんこ	|	|	|
非命の王フォノウ|断命の王ダークフォノウ	非命之王佛挪|斷命之王黑暗佛挪	King of Doom Phono|King of Extinction Phono	비명의 왕 포노아|단명의 왕 다크 포노아
古びたタマゴ:N108|青いタマゴ:N108|ネコウォッシュ	遠古的蛋：N108|藍色的蛋：N108|香皂貓	Ancient Egg: N108|Teal Egg: N108|Soap Cat	오래된 알: N108|푸른 알: N108|고양이 비누
古びたタマゴ:N109|悪のタマゴ:N109|ネコバレル	遠古的蛋：N109|邪惡的蛋：N109|海盜桶貓	Ancient Egg: N109|Dark Egg: N109|Barrel Cat	오래된 알: N109|악의 알: N109|고양이 나무통
ネコジェット|ネコ宮金次郎	噴射貓|貓宮金次郎	Jetpack Cat|Kinjirou Cat	고양이 제트|고양이 주경야독
隻眼の少女アスカ|碧眼の魔女アスカ	獨眼少女明日香|藍眼魔女明日香	One-Eyed Asuka|Blue-Eyed Asuka	외눈의 소녀 아스카|푸른 눈의 마녀 아스카
エヴァ第１３号機|エヴァ第１３号機＆ネコ	EVA第13號機|EVA第13號機&貓咪	Eva Unit-13|Eva Unit-13 & Cat	에바 13호기|에바 13호기&고양이
バララガの誓い|オヨメノパサラン	婚紗異能貓|新娘異能貓	Betrothed Balaluga|Betrothed Pasalan	바라라가의 서약|새신부파사란
カオルガ|カオランパサラン	額頭貓|額頭白骨貓	Kaoluga|Kaoluga Pasalan	카오루가|카오란파사란
古びたタマゴ:N203|紫のタマゴ:N203|ネコピエロ	遠古的蛋：N203|紫色的蛋：N203|小丑貓	Ancient Egg: N203|Violet Egg: N203|Clown Cat	오래된 알: N203|보라색 알: N203|고양이 삐에로
波打ち際の冒険家カンナ|大海原のダイバーカンナ	岸邊冒險家佳奈|大海潛水家佳奈	Coastal Explorer Kanna|Deep-Diver Kanna	비치 다이빙 모험가 칸나|테크니컬 다이버 칸나
建築兵団スフィンクス|突撃部隊コンボーイズ	建築兵團・運輸隊|突擊部隊・卡車隊	Mighty Sphinx Korps|Attack Battalion Convoys	건설병단 스핑크스|돌격부대 콘보이즈
古びたタマゴ:N111|謎のタマゴ:N111|ネコポリス	遠古的蛋：N111|謎樣的蛋：N111|警官貓	Ancient Egg: N111|Mystic Egg: N111|Cop Cat	오래된 알: N111|신비한 알: N111|고양이 폴리스
古びたタマゴ:N110|黄色いタマゴ:N110|ネコファーマー	遠古的蛋：N110|黃色的蛋：N110|農夫貓	Ancient Egg: N110|Amber Egg: N110|Farmboy Cat	오래된 알: N110|노란 알: N110|고양이 농부
ネコもろこし|にゃんコーン	玉蜀黍貓|三角錐貓	Maize Cat|Cone Cat	고양이 옥수수|냥코콘
鉄の精霊カッチン|鋼鉄の精霊テツカッチン	鐵精靈卡卿|鋼鐵精靈鐵卡卿	Tekachi|Tetsukachi	철의 정령 메탈릭|강철의 정령 헤비메탈
古びたタマゴ:N006|悪のタマゴ:N006|ネコアックマ	遠古的蛋：N006|邪惡的蛋：N006|惡魔熊熊貓	Ancient Egg: N006|Devil Egg: N006|Fallen Bear Cat	오래된 알: N006|악의 알: N006|고양이 악마 각하
花園高校番長りき|ドッジボール部りき	花園高中老大阿力|躲避球社阿力	High School Kingpin Riki|Dodgeball Riki	화원고교 번장 리키|피구부 리키
初音ミク 16th|初音ミクCC 16th	初音未來 16th|初音未來CC 16th	Hatsune Miku XVI|Hatsune Miku XVI CC	하츠네 미쿠 16th|하츠네 미쿠CC 16th
光翼神イシス|ネフェルイシス	光翼神伊西絲|美翼神伊西絲	Lightmother Aset|Nefer Aset	광익신 이시스|네페르 이시스
古びたタマゴ:N112|謎のタマゴ:N112|ネコタマ号	遠古的蛋：N112|謎樣的蛋：N112|蛋蛋號貓	Ancient Egg: N112|Mystic Egg: N112|Cat Egg Pod	오래된 알: N112|신비한 알: N112|고양이 에그호
忍者娘トモエ|食道楽忍者トモエ	忍者女孩多萌耶|響食忍者多萌耶	Ninja Girl Tomoe|Gourmand Ninja Girl Tomoe	닌자아가씨 토모에|식도락 닌자 토모에
ネコメダル王|ネコメダル大王	|	|	|
ソル・デ・ロカ|ソル・デ・ロカCC	太陽神羅卡|太陽神羅卡CC	SOL DAE ROKKER|SOL DAE ROKKER CC	솔 데 로카|솔 데 로카CC
論の賢者ソラクティス|論の賢者ネコラティス	論之賢者蘇拉格底|論之賢者貓拉格底	Master of Mind Soractes|Master of Mind Catcrates	논리의 현자 소라크테스|논리의 현자 냥코라테스
730_1	730_1	730_1	730_1
古びたタマゴ:N204|赤いタマゴ:N204|ねこシシマイ	遠古的蛋：N204|紅色的蛋：N204|舞獅貓	Ancient Egg: N204|Cinnabar Egg: N204|Lion Dancer Cat	오래된 알: N204|붉은 알: N204|고양이 사자놀이
暁のイザナギ|暁光のイザナギ	曉之伊邪那岐|曉光之伊邪那岐	Daybreaker Izanagi|Dawnbringer Izanagi	새벽의 이자나기|여명의 이자나기
733_1	733_1	733_1	733_1
鉄籠のペガサ|鉄籠のペガサν	鐵籠的姵卡薩|鐵籠的姵卡薩ν	Pegasa|Pegasa ν	페가사|페가사ν
735_1	735_1	735_1	735_1
ネコ校長|ネコセカンドライフ	校長貓|第二人生貓	Principal Cat|Midlife Crisis Cat	고양이 교장|고양이 세컨드 라이프
ネコアイスホワイトスター|ネコアイストップスター	冰雪白星貓|冰雪巨星貓	Frozen Rose Cat|Arctic Bloom Cat	고양이 아이스 화이트스타|고양이 아이스 톱스타
スプリングカリファ|スプリングXカリファ	春季卡莉法|春季卡莉法Ｘ	Floral Kalisa|Floral Kalisa, type X	스프링 칼리파|스프링X칼리파
宵のイザナミ|宵闇のイザナミ	宵之伊邪那美|宵暗之伊邪那美	Izanami of Dusk|Izanami of Eventide	해질녘의 이자나미|황혼의 이자나미
740_1	740_1	740_1	740_1
741-1|741-2	垃圾桶貓|寶箱貓	Trash Cat|Mimic Cat	|
742-1|742-2	染香綺狐 ‧ 妲己|染香綺狐 ‧ 妲己＆貓咪	Voluptuous Peony - Daji|Daji & Cat	염향기호 다지|염향기호 다지&고양이
743-1|743-2	莫莉安娜貓|一曲傾心・莫莉安娜貓	Mollyanna Cat|Mesmerizing Tune - Mollyanna	모리아나 고양이|일곡경심 모리아나 고양이
744-1|744-2	瘋頭|瘋頭貓	Madhead|Madhead Cat	미친머리|냥코 미친머리
745-1|745-2	貓公爵 ‧ 費利克斯貓|傭兵貓團長 ‧ 費利克斯貓	Felix the Cat Duke Cat|Mercenary Leader Felix Cat	공작 펠릭스 고양이|용병단장 펠릭스 고양이
746-1|746-2	點點貓|生日派對點點貓	Dotty Cat|Birthday Dotty Cat	도티 고양이|버스데이 도티 고양이
緋村剣心|緋村剣心CC	緋村劍心|緋村劍心CC	Kenshin Himura|Kenshin Himura CC	히무라 켄신|히무라 켄신CC
相楽左之助|相楽左之助CC	相樂左之助|相樂左之助CC	Sanosuke Sagara|Sanosuke Sagara CC	사가라 사노스케|사가라 사노스케CC
四乃森蒼紫|四乃森蒼紫CC	四乃森蒼紫|四乃森蒼紫CC	Aoshi Shinomori|Aoshi Shinomori CC	시노모리 아오시|시노모리 아오시CC
斎藤一|斎藤一CC	齋藤一|齋藤一CC	Hajime Saito|Hajime Saito CC	사이토 하지메|사이토 하지메CC
ちび薫|ちび薫CC	小小神谷薰|小小神谷薰CC	Li'l Kaoru|Li'l Kaoru CC	꼬맹이 카미야 카오루|꼬맹이 카오루CC
ちび弥彦|ちび弥彦CC	小小彌彥|小小彌彥CC	Li'l Yahiko|Li'l Yahiko CC	꼬맹이 야히코|꼬맹이 야히코CC
ネコ剣心|ネコ抜刀斎	劍心貓|拔刀齋貓	Kenshin Cat|Battosai Cat	고양이 켄신|고양이 발도재
ネコ薫|剣術小町ネコ薫	神谷薰貓|劍道之花神谷薰貓	Kaoru Cat|Swordscat Kaoru	고양이 카미야 카오루|미녀 검술가 고양이 카오루
明智光秀|武神・明智光秀	明智光秀|武神・明智光秀	Akechi Mitsuhide|Wargod Mitsuhide	알리칸토|분노의 알리칸토
756_1	756_1	756_1	756_1
ネコケーキマシン挙式|ネコケーキマシン挙式・寿	婚禮蛋糕機器貓|婚禮蛋糕機器貓・祝	Cake Machine|Wedding Cake Machine	고양이 웨딩 케이크 머신|고양이 웨딩 케이크 머신・축
古びたタマゴ:N205|紫のタマゴ:N205|ネコ花嫁	遠古的蛋：N205|紫色的蛋：N205|新娘貓	Ancient Egg: N205|Violet Egg: N205|Bride Cat	오래된 알: N205|보라색 알: N205|고양이 신부
謎の傭兵トリクシー|復讐の傭兵トリクシー	炫幻傭兵特麗希|復仇傭兵特麗希	Trixi the Merc|Trixi the Revenant	정체불명 용병 트릭시|복수의 용병 트릭시
サマーフェスサンディア|サマーフェスサンディアβ	夏日音樂祭珊迪亞|夏日音樂祭珊迪亞β	Music Fest Thundia|Music Fest Thundia β	섬머 페스티벌 산디아|섬머 페스티벌 산디아β
砲龍ガンドロス|砲龍王ガンドロス	砲龍剛多羅斯|砲龍王剛多羅斯	Gunduros|Ballistic Dragon Gunduros	포룡 건듀로스|포룡왕 건듀로스
762_1	762_1	762_1	762_1
天空神スーパーゼウス|ギガント全能神スーパーゼウス	|	|	|
ネコダイナザウルス|メカ・ネコダイナザウルス	噴火恐龍貓|機械噴火恐龍貓	Dynasaurus Cat|Mecha Dynasaurus Cat	고양이 다이너사우루스|메카 고양이 다이너사우루스
765_1			
古びたタマゴ:N206|赤いタマゴ:N206|ネコホタテ	遠古的蛋：N206|紅色的蛋：N206|扇貝貓	Ancient Egg: N206|Cinnabar Egg: N206|Clam Cat	오래된 알: N206|붉은 알: N206|고양이 가리비
イワシ|イワシCC	沙丁魚|沙丁魚CC	Sardine|Sardine CC	정어리|정어리CC
イカ|イカCC	烏賊|烏賊CC	Squid|Squid CC	오징어|오징어CC
たいてんき|たいてんきCC	戴天鬼|戴天鬼CC	Taitenki|Taitenki CC	타이텐키|타이텐키CC
花咲かじいさん|暴食怪樹オオザクラ	開花爺爺|暴食怪樹大櫻	Hanasaka Cat|Ravenous Cherry	냥꽃 할배|폭식괴수 빅트리
771-1	771-1	771-1	771-1
生命の賢者Dr.ノーヴァ|生命の賢者ネコノーヴァ	生命賢者Dr. 諾瓦|生命賢者貓諾瓦	Master of Life Dr. Nova|Master of Life Catnova	생명의 현자 Dr.노바|생명의 현자 고양이 노바
パンプキンソドム|ソドム・オー・ランタン	南瓜索多姆|南瓜燈索多姆	Pumpkin Sodom|Sodom-o'-Lantern	펌킨 소돔|소돔 오 랜턴
スモウ・ザ・ミイラ|マミー・ザ・ハロウィン	木乃伊相撲貓|萬聖節變裝女士	Mummy Sumo|Mama Mummy Sumo	스모 더 미라|마미 더 할로윈
特命機動アクセル|ダーティー・アクセル	特命交警阿酷賽爾|酷頑夜警阿酷賽爾	Mech Patrol Axel|Steel Sergeant Axel	특수기동대 엑셀|더티 엑셀
776-1	776-1	776-1	776-1
見習い武者ネコ|武将ネコ	|	|	|
冬将軍・成田甲斐|冬大将軍・成田甲斐	冬將軍・成田甲斐|冬大將軍・成田甲斐	Winter General Kaihime|Winter Commander Kaihime	동장군 미네르바|한파장군 미네르바
ネコまどか＆ほむら|魔法結社にゃんこ☆マギカ	小圓貓＆小焰|魔法結社貓咪小圓	Madoka Cat & Homura|Magical Cat☆ Magica	고양이 마도카&호무라|마법결사 냥코☆마기카
幼天女ルーナ|救済の天女ルナーシャ	幼天女露娜|救濟天女露娜夏	Celestial Child Luna|Salvation's Daughter Lunacia	꼬마선녀 루나|구제의 선녀 루나샤
ネコボウラー|ネコドッジボウラー	保齡球選手貓|躲避球選手貓	Bowler Cat|Dodgeballer Cat	고양이 볼링선수|고양이 피구선수
マモルガ|マモランパサラン	眼擊貓|眼擊白骨貓	Mamoluga|Mamolan Pasalan	마모루가|마모란파사란
783-1	783-1	783-1	783-1
こねこ|超スターこねこ	俏喵|超級明星俏喵	Koneko|Superstar Koneko	꼬꼬미|울트라 스타 꼬꼬미
チョコサプネコC|チョコサプネコF	|	|	|
殺意のキモネコ|真・殺意のキモネコ	|	|	|
マジシャンキャットマン|イリュージョンキャットマン	魔術師貓俠|幻術師貓俠	The Amazing Catman|Illusionist Catman	매지션 캣맨|일루전 캣맨
冥護の天女ルナーシャ|寂滅の天女ダークルナーシャ	冥佑天女露娜夏|寂滅天女黑露娜夏	Netherworld Nymph Lunacia|Death's Daughter Lunacia	비호의 선녀 루나샤|적멸의 선녀 다크 루나샤
789-1|789-2	|	|	상자 고양이|깜짝상자 고양이
範馬刃牙|範馬刃牙CC	範馬刃牙|範馬刃牙CC	Baki Hanma|Baki Hanma CC	한마 바키|한마 바키CC
烈海王|烈海王CC	烈海王|烈海王CC	Retsu Kaioh|Retsu Kaioh CC	레츠 카이오|레츠 카이오CC
花山薫|花山薫CC	花山薰|花山薰CC	Kaoru Hanayama|Kaoru Hanayama CC	하나야마 카오루|하나야마 카오루CC
愚地克巳|愚地克巳CC	愚地克巳|愚地克巳CC	Katsumi Orochi|Katsumi Orochi CC	오로치 카츠미|오로치 카츠미CC
ジャック・ハンマー|ジャック・ハンマーCC	傑克・範馬|傑克・範馬CC	Jack Hammer|Jack Hammer CC	잭 한마|잭 한마CC
ネコオーガ|ネコの貌	勇次郎貓|鬼背貓	Ogre Cat|Ogre Cat Face	고양이 오거|고양이의 얼굴
ちび刃牙|ちび刃牙CC	小小刃牙|小小刃牙CC	Li'l Baki|Li'l Baki CC	꼬맹이 바키|꼬맹이 바키CC
ネコ刃牙|ネコ刃牙CC	刃牙貓|刃牙貓CC	Baki Cat|Baki Cat CC	고양이 바키|고양이 바키CC
ネコ海王|ネコ海王CC	海王貓|海王貓CC	Kaioh Cat|Kaioh Cat CC	고양이 카이오|고양이 카이오CC
ネコ独歩|ネコ独歩CC	獨步貓|獨步貓CC	Doppo Cat|Doppo Cat CC	고양이 돗포|고양이 돗포CC